state_code,district_code,sub_district_code,level,area_name,noofvillages,total_population,male_population,female_population
00,000,00000,INDIA,INDIA,597608,833748852,427781058,405967794
01,000,00000,STATE,JAMMU & KASHMIR,6337,9108060,4774477,4333583
01,001,00000,DISTRICT,Kupwara,353,765625,412038,353587
01,001,00001,SUB-DISTRICT,Kupwara,118,465323,252856,212467
01,001,00002,SUB-DISTRICT,Handwara,196,255711,134503,121208
01,001,00003,SUB-DISTRICT,Karnah,39,44591,24679,19912
01,002,00000,DISTRICT,Badgam,462,655833,343385,312448
01,002,00004,SUB-DISTRICT,Khag,49,67596,34457,33139
01,002,00005,SUB-DISTRICT,Beerwah,102,149671,80103,69568
01,002,00006,SUB-DISTRICT,Khansahib,96,120682,62783,57899
01,002,00007,SUB-DISTRICT,Budgam,95,111056,57359,53697
01,002,00008,SUB-DISTRICT,Chadoora,104,164945,86218,78727
01,002,00009,SUB-DISTRICT,Charar- E- Shrief,16,41883,22465,19418
01,003,00000,DISTRICT,Leh(Ladakh),111,87816,48411,39405
01,003,00010,SUB-DISTRICT,Leh,60,48290,26037,22253
01,003,00011,SUB-DISTRICT,Nubra,28,22433,13740,8693
01,003,00012,SUB-DISTRICT,Khalsi,23,17093,8634,8459
01,004,00000,DISTRICT,Kargil,125,124464,67703,56761
01,004,00013,SUB-DISTRICT,Kargil,64,70123,39349,30774
01,004,00014,SUB-DISTRICT,Sanku,36,40548,21346,19202
01,004,00015,SUB-DISTRICT,Zanskar,25,13793,7008,6785
01,005,00000,DISTRICT,Punch,170,438205,229774,208431
01,005,00016,SUB-DISTRICT,Haveli,49,105913,55475,50438
01,005,00017,SUB-DISTRICT,Mandi,37,77947,41365,36582
01,005,00018,SUB-DISTRICT,Mendhar,51,136333,70776,65557
01,005,00019,SUB-DISTRICT,Surankote,33,118012,62158,55854
01,006,00000,DISTRICT,Rajouri,375,590101,310748,279353
01,006,00020,SUB-DISTRICT,Thanamandi,32,62283,32373,29910
01,006,00021,SUB-DISTRICT,Darhal,11,36227,19121,17106
01,006,00022,SUB-DISTRICT,Rajauri,118,159581,84130,75451
01,006,00023,SUB-DISTRICT,Budhal,51,123050,64990,58060
01,006,00024,SUB-DISTRICT,Kalakote,68,72667,37864,34803
01,006,00025,SUB-DISTRICT,Nowshehra,52,79008,42417,36591
01,006,00026,SUB-DISTRICT,Sunderbani,43,57285,29853,27432
01,007,00000,DISTRICT,Kathua,496,526722,278126,248596
01,007,00027,SUB-DISTRICT,Billawar,65,145904,77072,68832
01,007,00028,SUB-DISTRICT,Bashohli,38,65377,34351,31026
01,007,00029,SUB-DISTRICT,Bani,33,45996,23889,22107
01,007,00030,SUB-DISTRICT,Kathua,163,139941,74698,65243
01,007,00031,SUB-DISTRICT,Hiranagar,197,129504,68116,61388
01,008,00000,DISTRICT,Baramula,509,825539,432399,393140
01,008,00032,SUB-DISTRICT,Sopore,57,148621,75856,72765
01,008,00033,SUB-DISTRICT,Rafiabad,77,85624,43789,41835
01,008,00034,SUB-DISTRICT,Pattan,94,209617,110686,98931
01,008,00035,SUB-DISTRICT,Baramulla,42,78215,40998,37217
01,008,00036,SUB-DISTRICT,Kreeri,50,66954,34447,32507
01,008,00037,SUB-DISTRICT,Uri,41,65501,35153,30348
01,008,00038,SUB-DISTRICT,Boniyar,52,72564,39566,32998
01,008,00039,SUB-DISTRICT,Tangmarg ,96,98443,51904,46539
01,009,00000,DISTRICT,Bandipore,119,326871,172263,154608
01,009,00040,SUB-DISTRICT,Gurez,28,37992,22978,15014
01,009,00041,SUB-DISTRICT,Bandipora,41,140657,72858,67799
01,009,00042,SUB-DISTRICT,Sonawari,50,148222,76427,71795
01,010,00000,DISTRICT,Srinagar,11,17313,8916,8397
01,010,00043,SUB-DISTRICT,Srinagar (North),8,10910,5725,5185
01,010,00044,SUB-DISTRICT,Srinagar (South),3,6403,3191,3212
01,011,00000,DISTRICT,Ganderbal,113,250407,133715,116692
01,011,00045,SUB-DISTRICT,Lar,42,80223,43281,36942
01,011,00046,SUB-DISTRICT,Kangan,42,120934,64723,56211
01,011,00047,SUB-DISTRICT,Ganderbal,29,49250,25711,23539
01,012,00000,DISTRICT,Pulwama,319,479978,248096,231882
01,012,00048,SUB-DISTRICT,Pampore,23,50033,26255,23778
01,012,00049,SUB-DISTRICT,Awantipora,43,73860,38169,35691
01,012,00050,SUB-DISTRICT,Tral,66,92352,47592,44760
01,012,00051,SUB-DISTRICT,Pulwama,187,263733,136080,127653
01,013,00000,DISTRICT,Shupiyan,226,249855,127161,122694
01,013,00052,SUB-DISTRICT,Shopian,226,249855,127161,122694
01,014,00000,DISTRICT,Anantnag,335,795805,411012,384793
01,014,00053,SUB-DISTRICT,Pahalgam,65,104101,53290,50811
01,014,00054,SUB-DISTRICT,Bijbehara,51,112197,56259,55938
01,014,00055,SUB-DISTRICT,Anantnag,82,179530,91832,87698
01,014,00056,SUB-DISTRICT,Shangus,25,66228,34917,31311
01,014,00057,SUB-DISTRICT,Kokernag,51,167159,87355,79804
01,014,00058,SUB-DISTRICT,Dooru,61,166590,87359,79231
01,015,00000,DISTRICT,Kulgam,226,343870,175574,168296
01,015,00059,SUB-DISTRICT,Kulgam,161,214925,109277,105648
01,015,00060,SUB-DISTRICT, Devsar,15,22128,11344,10784
01,015,00061,SUB-DISTRICT,Damhal Hanjipora,50,106817,54953,51864
01,016,00000,DISTRICT,Doda,402,377247,195430,181817
01,016,00062,SUB-DISTRICT,Doda,126,181111,93703,87408
01,016,00063,SUB-DISTRICT,Thathri,92,59955,31627,28328
01,016,00064,SUB-DISTRICT,Gandoh,66,71889,36754,35135
01,016,00065,SUB-DISTRICT,Bhaderwah,118,64292,33346,30946
01,017,00000,DISTRICT,Ramban,127,271902,142317,129585
01,017,00066,SUB-DISTRICT,Banihal,33,121145,62539,58606
01,017,00067,SUB-DISTRICT,Ramban,94,150757,79778,70979
01,018,00000,DISTRICT,Kishtwar,155,215831,111986,103845
01,018,00068,SUB-DISTRICT,Kishtwar,82,114624,59530,55094
01,018,00069,SUB-DISTRICT,Marwah,27,35572,18364,17208
01,018,00070,SUB-DISTRICT,Chhatroo,14,44087,22815,21272
01,018,00071,SUB-DISTRICT,Atholi (Paddar),32,21548,11277,10271
01,019,00000,DISTRICT,Udhampur,325,446777,232974,213803
01,019,00072,SUB-DISTRICT,Udhampur,149,177828,92989,84839
01,019,00073,SUB-DISTRICT,Chenani,46,60568,31380,29188
01,019,00074,SUB-DISTRICT,Ramnagar,88,160718,83518,77200
01,019,00075,SUB-DISTRICT,Majalta,42,47663,25087,22576
01,020,00000,DISTRICT,Reasi,253,287671,151481,136190
01,020,00076,SUB-DISTRICT,Gool-Gulabgarh,61,147843,78181,69662
01,020,00077,SUB-DISTRICT,Reasi,192,139828,73300,66528
01,021,00000,DISTRICT,Jammu,780,764945,401603,363342
01,021,00078,SUB-DISTRICT,Akhnoor,207,218825,114114,104711
01,021,00079,SUB-DISTRICT,Jammu,309,284890,150516,134374
01,021,00080,SUB-DISTRICT,Ranbir Singh Pora,163,169459,89097,80362
01,021,00081,SUB-DISTRICT,Bishnah,101,91771,47876,43895
01,022,00000,DISTRICT,Samba,345,265283,139365,125918
01,022,00082,SUB-DISTRICT,Samba,345,265283,139365,125918
02,000,00000,STATE,HIMACHAL PRADESH,17882,6176050,3110345,3065705
02,023,00000,DISTRICT,Chamba,1110,482972,241963,241009
02,023,00083,SUB-DISTRICT,Pangi,60,18868,9579,9289
02,023,00084,SUB-DISTRICT,Chaurah,181,78988,40152,38836
02,023,00085,SUB-DISTRICT,Saluni,132,47939,24197,23742
02,023,00086,SUB-DISTRICT,Bhalai,78,25326,12561,12765
02,023,00087,SUB-DISTRICT,Dalhousie,119,36160,17968,18192
02,023,00088,SUB-DISTRICT,Bhattiyat,123,37392,18535,18857
02,023,00089,SUB-DISTRICT,Sihunta,80,39871,19634,20237
02,023,00090,SUB-DISTRICT,Chamba,241,159320,79228,80092
02,023,00091,SUB-DISTRICT,Holi,46,14094,7236,6858
02,023,00092,SUB-DISTRICT,Brahmaur,50,25014,12873,12141
02,024,00000,DISTRICT,Kangra,3617,1423794,705365,718429
02,024,00093,SUB-DISTRICT,Nurpur,392,166718,84969,81749
02,024,00094,SUB-DISTRICT,Indora,112,76692,39901,36791
02,024,00095,SUB-DISTRICT,Fatehpur,223,62041,31105,30936
02,024,00096,SUB-DISTRICT,Jawali,195,112746,56022,56724
02,024,00097,SUB-DISTRICT,Harchakian,60,13841,6746,7095
02,024,00098,SUB-DISTRICT,Shahpur,152,67758,33220,34538
02,024,00099,SUB-DISTRICT,Dharmsala,151,93744,47329,46415
02,024,00100,SUB-DISTRICT,Kangra,161,88040,44302,43738
02,024,00101,SUB-DISTRICT,Nagrota Bagwan,157,70999,35346,35653
02,024,00102,SUB-DISTRICT,Baroh,161,25789,12403,13386
02,024,00103,SUB-DISTRICT,Dera Gopipur,282,115967,56094,59873
02,024,00104,SUB-DISTRICT,Jawalamukhi,122,38143,18404,19739
02,024,00105,SUB-DISTRICT,Jaswan,86,32520,15907,16613
02,024,00106,SUB-DISTRICT,Rakkar,103,29503,14451,15052
02,024,00107,SUB-DISTRICT,Khundian,216,38231,18607,19624
02,024,00108,SUB-DISTRICT,Thural,84,19287,9034,10253
02,024,00109,SUB-DISTRICT,Dhira,113,22119,10498,11621
02,024,00110,SUB-DISTRICT,Jaisinghpur,218,61082,27938,33144
02,024,00111,SUB-DISTRICT,Palampur,395,185733,91993,93740
02,024,00112,SUB-DISTRICT,Baijnath,200,95229,47175,48054
02,024,00113,SUB-DISTRICT,Multhan,34,7612,3921,3691
02,025,00000,DISTRICT,Lahul & Spiti,280,31564,16588,14976
02,025,00114,SUB-DISTRICT,Udaipur,66,8889,4482,4407
02,025,00115,SUB-DISTRICT,Lahul,132,10218,5415,4803
02,025,00116,SUB-DISTRICT,Spiti,82,12457,6691,5766
02,026,00000,DISTRICT,Kullu,314,396512,203269,193243
02,026,00117,SUB-DISTRICT,Manali,70,43565,22993,20572
02,026,00118,SUB-DISTRICT,Kullu,156,174835,89410,85425
02,026,00119,SUB-DISTRICT,Sainj,14,25908,13342,12566
02,026,00120,SUB-DISTRICT,Banjar,31,42198,21445,20753
02,026,00121,SUB-DISTRICT,Ani,17,56917,29077,27840
02,026,00122,SUB-DISTRICT,Nermand,26,53089,27002,26087
02,027,00000,DISTRICT,Mandi,2850,937140,466050,471090
02,027,00123,SUB-DISTRICT,Padhar,193,49357,24963,24394
02,027,00124,SUB-DISTRICT,Jogindarnagar,208,79135,38538,40597
02,027,00125,SUB-DISTRICT,Lad Bharol,146,25832,11649,14183
02,027,00126,SUB-DISTRICT,Sandhol,57,16925,8067,8858
02,027,00127,SUB-DISTRICT,Dharmpur,95,34777,16550,18227
02,027,00128,SUB-DISTRICT,Kotli,64,25860,12464,13396
02,027,00129,SUB-DISTRICT,Sarkaghat,179,59554,28700,30854
02,027,00130,SUB-DISTRICT,Bhadrota,93,21542,10705,10837
02,027,00131,SUB-DISTRICT,Baldwara,134,43811,21444,22367
02,027,00132,SUB-DISTRICT,Sundarnagar,160,87007,43976,43031
02,027,00133,SUB-DISTRICT,Mandi,368,187808,94438,93370
02,027,00134,SUB-DISTRICT,Aut,60,30893,15641,15252
02,027,00135,SUB-DISTRICT,Bali Chowki,97,37913,19389,18524
02,027,00136,SUB-DISTRICT,Thunag,172,50308,25461,24847
02,027,00137,SUB-DISTRICT,Chachyot,156,57723,28892,28831
02,027,00138,SUB-DISTRICT,Nihri,204,35569,18051,17518
02,027,00139,SUB-DISTRICT,Karsog,464,93126,47122,46004
02,028,00000,DISTRICT,Hamirpur,1671,423338,200748,222590
02,028,00140,SUB-DISTRICT,Tira Sujanpur,195,38064,17362,20702
02,028,00141,SUB-DISTRICT,Nadaun,359,76659,37179,39480
02,028,00142,SUB-DISTRICT,Galore,109,26957,12716,14241
02,028,00143,SUB-DISTRICT,Hamirpur,374,99344,47799,51545
02,028,00144,SUB-DISTRICT,Barsar,233,54103,25917,28186
02,028,00145,SUB-DISTRICT,Dhatwal,128,37621,17579,20042
02,028,00146,SUB-DISTRICT,Bhoranj,273,90590,42196,48394
02,029,00000,DISTRICT,Una,790,476260,240254,236006
02,029,00147,SUB-DISTRICT,Bharwain,46,17847,8997,8850
02,029,00148,SUB-DISTRICT,Amb,241,161183,81129,80054
02,029,00149,SUB-DISTRICT,Bangana,305,73035,36336,36699
02,029,00150,SUB-DISTRICT,Una,139,152779,77484,75295
02,029,00151,SUB-DISTRICT,Haroli,59,71416,36308,35108
02,030,00000,DISTRICT,Bilaspur,953,356827,179653,177174
02,030,00152,SUB-DISTRICT,Ghumarwin,210,81617,40436,41181
02,030,00153,SUB-DISTRICT,Bharari,98,45713,22160,23553
02,030,00154,SUB-DISTRICT,Jhanduta,227,89190,44916,44274
02,030,00155,SUB-DISTRICT,Naina Devi,142,45480,23622,21858
02,030,00156,SUB-DISTRICT,Bilaspur Sadar,160,62060,31808,30252
02,030,00157,SUB-DISTRICT,Namhol,116,32767,16711,16056
02,031,00000,DISTRICT,Solan,2383,478173,249736,228437
02,031,00158,SUB-DISTRICT,Arki,297,53868,26831,27037
02,031,00159,SUB-DISTRICT,Darlaghat,185,36763,19123,17640
02,031,00160,SUB-DISTRICT,Ramshahr,217,32594,16601,15993
02,031,00161,SUB-DISTRICT,Nalagarh,282,103503,54657,48846
02,031,00162,SUB-DISTRICT,Baddi,187,61031,32976,28055
02,031,00163,SUB-DISTRICT,Krishangarh,211,24511,12400,12111
02,031,00164,SUB-DISTRICT,Kasauli,265,54621,29911,24710
02,031,00165,SUB-DISTRICT,Solan,472,70753,36280,34473
02,031,00166,SUB-DISTRICT,Kandaghat,267,40529,20957,19572
02,032,00000,DISTRICT,Sirmaur,968,472690,246175,226515
02,032,00167,SUB-DISTRICT,Rajgarh,140,45916,23599,22317
02,032,00168,SUB-DISTRICT,Nohra,47,23022,11730,11292
02,032,00169,SUB-DISTRICT,Pachhad,262,53800,27912,25888
02,032,00170,SUB-DISTRICT,Renuka,74,47388,24221,23167
02,032,00171,SUB-DISTRICT,Dadahu,72,17403,8870,8533
02,032,00172,SUB-DISTRICT,Nahan,137,55250,28852,26398
02,032,00173,SUB-DISTRICT,Paonta Sahib,141,132616,69750,62866
02,032,00174,SUB-DISTRICT,Kamrau,45,37066,19400,17666
02,032,00175,SUB-DISTRICT,Shalai,28,36905,19403,17502
02,032,00176,SUB-DISTRICT,Ronhat,22,23324,12438,10886
02,033,00000,DISTRICT,Shimla,2705,612659,314295,298364
02,033,00177,SUB-DISTRICT,Rampur,152,67232,35100,32132
02,033,00178,SUB-DISTRICT,Nankhari,84,26238,13292,12946
02,033,00179,SUB-DISTRICT,Kumharsain,171,42161,21354,20807
02,033,00180,SUB-DISTRICT,Seoni,199,32788,16281,16507
02,033,00181,SUB-DISTRICT,Shimla   ( Rural ),540,82320,42588,39732
02,033,00182,SUB-DISTRICT,Shimla (urban),0,0,0,0
02,033,00183,SUB-DISTRICT,Junga,59,13398,6834,6564
02,033,00184,SUB-DISTRICT,Theog,446,80331,40991,39340
02,033,00185,SUB-DISTRICT,Chaupal,158,29267,14976,14291
02,033,00186,SUB-DISTRICT,Cheta,58,19460,10094,9366
02,033,00187,SUB-DISTRICT,Nerua,189,36517,18751,17766
02,033,00188,SUB-DISTRICT,Jubbal,134,35997,18414,17583
02,033,00189,SUB-DISTRICT,Kotkhai,219,38015,19404,18611
02,033,00190,SUB-DISTRICT,Tikar,41,13806,7202,6604
02,033,00191,SUB-DISTRICT,Rohru,129,42615,21848,20767
02,033,00192,SUB-DISTRICT,Chirgaon,116,46142,23839,22303
02,033,00193,SUB-DISTRICT,Dodra Kwar,10,6372,3327,3045
02,034,00000,DISTRICT,Kinnaur,241,84121,46249,37872
02,034,00194,SUB-DISTRICT,Hangrang,16,4659,2390,2269
02,034,00195,SUB-DISTRICT,Poo,28,8309,4681,3628
02,034,00196,SUB-DISTRICT,Morang,37,10238,5403,4835
02,034,00197,SUB-DISTRICT,Kalpa,39,19190,10321,8869
02,034,00198,SUB-DISTRICT,Nichar,85,27683,15463,12220
02,034,00199,SUB-DISTRICT,Sangla,36,14042,7991,6051
03,000,00000,STATE,PUNJAB,12168,17344192,9093476,8250716
03,035,00000,DISTRICT,Gurdaspur,1515,1639004,855784,783220
03,035,00200,SUB-DISTRICT,Dhar Kalan,27,48780,25414,23366
03,035,00201,SUB-DISTRICT,Pathankot       ,336,329652,172345,157307
03,035,00202,SUB-DISTRICT,Gurdaspur ,676,674345,350455,323890
03,035,00203,SUB-DISTRICT,Batala ,358,472327,247569,224758
03,035,00204,SUB-DISTRICT,Dera Baba Nanak  ,118,113900,60001,53899
03,036,00000,DISTRICT,Kapurthala ,612,532706,275932,256774
03,036,00205,SUB-DISTRICT,Bhulath,94,83690,42391,41299
03,036,00206,SUB-DISTRICT,Kapurthala ,241,218983,114228,104755
03,036,00207,SUB-DISTRICT,Sultanpur Lodhi ,175,104939,54506,50433
03,036,00208,SUB-DISTRICT,Phagwara ,102,125094,64807,60287
03,037,00000,DISTRICT,Jalandhar,922,1032419,528790,503629
03,037,00209,SUB-DISTRICT,Shahkot,176,141682,72574,69108
03,037,00210,SUB-DISTRICT,Nakodar,146,171184,87411,83773
03,037,00211,SUB-DISTRICT,Phillaur,225,311277,159096,152181
03,037,00212,SUB-DISTRICT,Jalandhar - I,137,171718,87699,84019
03,037,00213,SUB-DISTRICT,Jalandhar - II,238,236558,122010,114548
03,038,00000,DISTRICT,Hoshiarpur,1385,1251656,634470,617186
03,038,00214,SUB-DISTRICT,Dasua,379,304301,153601,150700
03,038,00215,SUB-DISTRICT,Mukerian ,304,273924,137646,136278
03,038,00216,SUB-DISTRICT,Hoshiarpur ,406,371035,189724,181311
03,038,00217,SUB-DISTRICT,Garhshankar,296,302396,153499,148897
03,039,00000,DISTRICT,Shahid Bhagat Singh Nagar ,458,486894,248118,238776
03,039,00218,SUB-DISTRICT,Nawanshahr,275,327350,165659,161691
03,039,00219,SUB-DISTRICT,Balachaur,183,159544,82459,77085
03,040,00000,DISTRICT,Fatehgarh Sahib,442,414681,220050,194631
03,040,00220,SUB-DISTRICT,Bassi Pathana,100,75875,40254,35621
03,040,00221,SUB-DISTRICT,Fatehgarh Sahib,170,144237,76457,67780
03,040,00222,SUB-DISTRICT,Amloh,100,113666,60769,52897
03,040,00223,SUB-DISTRICT,Khamanon,72,80903,42570,38333
03,041,00000,DISTRICT,Ludhiana,885,1429031,753444,675587
03,041,00224,SUB-DISTRICT,Samrala,196,178791,93791,85000
03,041,00225,SUB-DISTRICT,Khanna,67,94160,49579,44581
03,041,00226,SUB-DISTRICT,Payal,105,172631,91242,81389
03,041,00227,SUB-DISTRICT,Ludhiana (East),181,279688,149023,130665
03,041,00228,SUB-DISTRICT,Ludhiana (West),125,272489,143430,129059
03,041,00229,SUB-DISTRICT,Raikot,72,155278,81700,73578
03,041,00230,SUB-DISTRICT,Jagraon,139,275994,144679,131315
03,042,00000,DISTRICT,Moga,319,768500,405704,362796
03,042,00231,SUB-DISTRICT,Nihal Singhwala,39,163823,86689,77134
03,042,00232,SUB-DISTRICT,Bagha Purana,56,200443,105936,94507
03,042,00233,SUB-DISTRICT,Moga,224,404234,213079,191155
03,043,00000,DISTRICT,Firozpur,955,1476518,776208,700310
03,043,00234,SUB-DISTRICT,Zira,206,190099,99182,90917
03,043,00235,SUB-DISTRICT,Firozpur,332,367255,193529,173726
03,043,00236,SUB-DISTRICT,Jalalabad ,206,299310,156475,142835
03,043,00237,SUB-DISTRICT,Fazilka,135,321890,168644,153246
03,043,00238,SUB-DISTRICT,Abohar ,76,297964,158378,139586
03,044,00000,DISTRICT,Muktsar,233,649705,342202,307503
03,044,00239,SUB-DISTRICT,Malout,91,266759,140341,126418
03,044,00240,SUB-DISTRICT,Gidderbaha,47,177567,93572,83995
03,044,00241,SUB-DISTRICT,Muktsar,95,205379,108289,97090
03,045,00000,DISTRICT,Faridkot,163,400457,210782,189675
03,045,00242,SUB-DISTRICT,Faridkot,122,276904,145755,131149
03,045,00243,SUB-DISTRICT,Jaitu,41,123553,65027,58526
03,046,00000,DISTRICT,Bathinda,279,889308,474484,414824
03,046,00244,SUB-DISTRICT,Rampura Phul,74,251179,132866,118313
03,046,00245,SUB-DISTRICT,Bathinda,118,397190,208686,188504
03,046,00246,SUB-DISTRICT,Talwandi Sabo,87,240939,132932,108007
03,047,00000,DISTRICT,Mansa,238,606147,322184,283963
03,047,00247,SUB-DISTRICT,Sardulgarh,70,155015,81841,73174
03,047,00248,SUB-DISTRICT,Budhlada,85,211102,111914,99188
03,047,00249,SUB-DISTRICT,Mansa,83,240030,128429,111601
03,048,00000,DISTRICT,Patiala,895,1132406,598800,533606
03,048,00250,SUB-DISTRICT,Samana,73,119898,63599,56299
03,048,00251,SUB-DISTRICT,Patran,68,155558,81722,73836
03,048,00252,SUB-DISTRICT,Nabha,169,191786,101593,90193
03,048,00253,SUB-DISTRICT,Patiala,345,381830,201496,180334
03,048,00254,SUB-DISTRICT,Rajpura,240,283334,150390,132944
03,049,00000,DISTRICT,Amritsar ,703,1156045,607266,548779
03,049,00255,SUB-DISTRICT,Ajnala,311,395492,207983,187509
03,049,00256,SUB-DISTRICT,Amritsar -I  ,139,254532,133311,121221
03,049,00257,SUB-DISTRICT,Amritsar- II ,100,224549,119201,105348
03,049,00258,SUB-DISTRICT,Baba Bakala ,153,281472,146771,134701
03,050,00000,DISTRICT,Tarn Taran,479,977832,514322,463510
03,050,00259,SUB-DISTRICT,Tarn Taran,193,426778,224628,202150
03,050,00260,SUB-DISTRICT,Patti ,192,363242,191685,171557
03,050,00261,SUB-DISTRICT,Khadur Sahib,94,187812,98009,89803
03,051,00000,DISTRICT,Rupnagar,591,506820,264089,242731
03,051,00262,SUB-DISTRICT,Anandpur Sahib,190,178163,91877,86286
03,051,00263,SUB-DISTRICT,Nangal,57,85088,43281,41807
03,051,00264,SUB-DISTRICT,Rup Nagar,161,106170,56169,50001
03,051,00265,SUB-DISTRICT,Chamkaur Sahib,183,137399,72762,64637
03,052,00000,DISTRICT,Sahibzada Ajit Singh Nagar,403,450017,240984,209033
03,052,00266,SUB-DISTRICT,Kharar,181,167209,89069,78140
03,052,00267,SUB-DISTRICT,SAS Nagar (Mohali),82,113448,60953,52495
03,052,00268,SUB-DISTRICT,Dera Bassi,140,169360,90962,78398
03,053,00000,DISTRICT,Sangrur,564,1139204,604653,534551
03,053,00269,SUB-DISTRICT,Malerkotla,180,255689,135014,120675
03,053,00270,SUB-DISTRICT,Dhuri,95,206022,109346,96676
03,053,00271,SUB-DISTRICT,Sangrur,123,228668,121633,107035
03,053,00272,SUB-DISTRICT,Sunam,81,237005,126496,110509
03,053,00273,SUB-DISTRICT,Lehra,39,109794,58280,51514
03,053,00274,SUB-DISTRICT,Moonak,46,102026,53884,48142
03,054,00000,DISTRICT,Barnala,127,404842,215210,189632
03,054,00275,SUB-DISTRICT,Barnala,77,239823,127744,112079
03,054,00276,SUB-DISTRICT,Tapa,50,165019,87466,77553
04,000,00000,STATE,CHANDIGARH,5,28991,17150,11841
04,055,00000,DISTRICT,Chandigarh,5,28991,17150,11841
04,055,00277,SUB-DISTRICT,Chandigarh,5,28991,17150,11841
05,000,00000,STATE,UTTARAKHAND,15745,7036954,3519042,3517912
05,056,00000,DISTRICT,Uttarkashi,694,305781,155375,150406
05,056,00278,SUB-DISTRICT,Puraula,83,33792,17106,16686
05,056,00279,SUB-DISTRICT,Mori,99,40491,20840,19651
05,056,00280,SUB-DISTRICT,Rajgarhi,182,63844,32440,31404
05,056,00281,SUB-DISTRICT,Dunda,126,60283,30080,30203
05,056,00282,SUB-DISTRICT,Chinyali Saur,104,49900,24443,25457
05,056,00283,SUB-DISTRICT,Bhatwari,100,57471,30466,27005
05,057,00000,DISTRICT,Chamoli,1170,332209,160369,171840
05,057,00284,SUB-DISTRICT,Joshimath ,91,29055,15786,13269
05,057,00285,SUB-DISTRICT,Chamoli,202,76894,38207,38687
05,057,00286,SUB-DISTRICT,Pokhari ,135,35890,16959,18931
05,057,00287,SUB-DISTRICT,Karnaprayag,207,38844,18106,20738
05,057,00288,SUB-DISTRICT,Tharali  ,315,89114,42556,46558
05,057,00289,SUB-DISTRICT,Gairsain,220,62412,28755,33657
05,058,00000,DISTRICT,Rudraprayag,653,232360,108740,123620
05,058,00290,SUB-DISTRICT,Ukhimath,232,86412,42005,44407
05,058,00291,SUB-DISTRICT,"Rudraprayag
",284,82546,37736,44810
05,058,00292,SUB-DISTRICT,Jakholi,137,63402,28999,34403
05,059,00000,DISTRICT,Tehri Garhwal,1774,548792,259381,289411
05,059,00293,SUB-DISTRICT,Ghansali,292,120775,54496,66279
05,059,00294,SUB-DISTRICT,Devprayag,365,90772,42780,47992
05,059,00295,SUB-DISTRICT,Pratapnagar,147,73592,34982,38610
05,059,00296,SUB-DISTRICT,Jakhani Dhar,134,32753,14992,17761
05,059,00297,SUB-DISTRICT,Tehri   ,329,85822,40305,45517
05,059,00298,SUB-DISTRICT,Dhanaulti,259,74083,37099,36984
05,059,00299,SUB-DISTRICT,Narendra Nagar,248,70995,34727,36268
05,060,00000,DISTRICT,Dehradun,731,754753,392891,361862
05,060,00300,SUB-DISTRICT,Chakrata ,110,44490,22819,21671
05,060,00301,SUB-DISTRICT,Tyuni,82,33926,17716,16210
05,060,00302,SUB-DISTRICT,Kalsi,169,47329,24840,22489
05,060,00303,SUB-DISTRICT,Vikas Nagar,136,265023,138565,126458
05,060,00304,SUB-DISTRICT,"Dehradun
",147,226042,117305,108737
05,060,00305,SUB-DISTRICT,"Rishikesh
",87,137943,71646,66297
05,061,00000,DISTRICT,Garhwal,3142,574568,268029,306539
05,061,00306,SUB-DISTRICT,Srinagar,180,33574,16434,17140
05,061,00307,SUB-DISTRICT,Pauri,732,109562,50111,59451
05,061,00308,SUB-DISTRICT,Thailisain,402,92286,41776,50510
05,061,00309,SUB-DISTRICT,Dhoomakot,331,39230,17661,21569
05,061,00310,SUB-DISTRICT,Lansdowne,483,71954,33141,38813
05,061,00311,SUB-DISTRICT,Satpuli,240,31494,14893,16601
05,061,00312,SUB-DISTRICT,Chaubatta Khal,247,38436,17190,21246
05,061,00313,SUB-DISTRICT,"Kotdwara
",301,119136,58172,60964
05,061,00314,SUB-DISTRICT,Yamkeshwar,226,38896,18651,20245
05,062,00000,DISTRICT,Pithoragarh,1572,413834,202930,210904
05,062,00315,SUB-DISTRICT,Munsiari,219,46523,22889,23634
05,062,00316,SUB-DISTRICT,Dharchula,71,58650,29443,29207
05,062,00317,SUB-DISTRICT,Didihat,363,73889,36273,37616
05,062,00318,SUB-DISTRICT,Berinag,283,52069,25121,26948
05,062,00319,SUB-DISTRICT,Gangolihat,312,71946,34419,37527
05,062,00320,SUB-DISTRICT,"Pithoragarh
",324,110757,54785,55972
05,063,00000,DISTRICT,Bageshwar,874,250819,119615,131204
05,063,00321,SUB-DISTRICT,Kapkot,146,64894,31064,33830
05,063,00322,SUB-DISTRICT,Kanda,160,26272,12354,13918
05,063,00323,SUB-DISTRICT,"Bageshwar
",378,91024,44385,46639
05,063,00324,SUB-DISTRICT,Garud,190,68629,31812,36817
05,064,00000,DISTRICT,"Almora
",2184,560192,257359,302833
05,064,00325,SUB-DISTRICT,Bhikiasain,376,70487,30555,39932
05,064,00326,SUB-DISTRICT,Chaukhutiya,164,46051,20047,26004
05,064,00327,SUB-DISTRICT,Sult,228,57126,25503,31623
05,064,00328,SUB-DISTRICT,Ranikhet,300,81238,38308,42930
05,064,00329,SUB-DISTRICT,"Dwarahat
",206,52319,22994,29325
05,064,00330,SUB-DISTRICT,"Almora
",428,123884,59981,63903
05,064,00331,SUB-DISTRICT,Someshwar,141,40282,18214,22068
05,064,00332,SUB-DISTRICT,Jainti,117,30981,14809,16172
05,064,00333,SUB-DISTRICT,Bhanoli,224,57824,26948,30876
05,065,00000,DISTRICT,Champawat,662,221305,110842,110463
05,065,00334,SUB-DISTRICT,Champawat,186,49723,25224,24499
05,065,00335,SUB-DISTRICT,Pati,139,45504,23038,22466
05,065,00336,SUB-DISTRICT,Lohaghat,267,78551,38240,40311
05,065,00337,SUB-DISTRICT,Poornagiri,70,47527,24340,23187
05,066,00000,DISTRICT,Nainital,1097,582871,299257,283614
05,066,00338,SUB-DISTRICT,Kosya Kutauli,118,31557,15657,15900
05,066,00339,SUB-DISTRICT,Betalghat,68,21265,10421,10844
05,066,00340,SUB-DISTRICT,Nainital,234,93583,48479,45104
05,066,00341,SUB-DISTRICT,Dhari,157,78733,40137,38596
05,066,00342,SUB-DISTRICT,"Haldwani
",202,119243,61676,57567
05,066,00343,SUB-DISTRICT,Ramnagar,146,98951,50542,48409
05,066,00344,SUB-DISTRICT,Kaladhungi,123,52459,26859,25600
05,066,00345,SUB-DISTRICT,Lalkuan,49,87080,45486,41594
05,067,00000,DISTRICT,Udham Singh Nagar,674,1062142,550470,511672
05,067,00346,SUB-DISTRICT,Kashipur,73,144297,75486,68811
05,067,00347,SUB-DISTRICT,Jaspur,97,112466,58959,53507
05,067,00348,SUB-DISTRICT,Bajpur,122,141749,73703,68046
05,067,00349,SUB-DISTRICT,Kichha,88,160697,84322,76375
05,067,00350,SUB-DISTRICT,Gadarpur,71,144204,74775,69429
05,067,00351,SUB-DISTRICT,Sitarganj,127,178154,91916,86238
05,067,00352,SUB-DISTRICT,"Khatima
",96,180575,91309,89266
05,068,00000,DISTRICT,Hardwar,518,1197328,633784,563544
05,068,00353,SUB-DISTRICT,Roorkee,266,645902,342776,303126
05,068,00354,SUB-DISTRICT,Hardwar,121,336937,177694,159243
05,068,00355,SUB-DISTRICT,"Laksar
",131,214489,113314,101175
06,000,00000,STATE,HARYANA,6642,16509359,8774006,7735353
06,069,00000,DISTRICT,Panchkula,206,248063,133153,114910
06,069,00356,SUB-DISTRICT,Kalka,95,94154,49527,44627
06,069,00357,SUB-DISTRICT,Panchkula,111,153909,83626,70283
06,070,00000,DISTRICT,Ambala,461,627576,331703,295873
06,070,00358,SUB-DISTRICT,Naraingarh,167,197785,104668,93117
06,070,00359,SUB-DISTRICT,Ambala,159,215397,113863,101534
06,070,00360,SUB-DISTRICT,Barara,135,214394,113172,101222
06,071,00000,DISTRICT,Yamunanagar,611,741376,393957,347419
06,071,00361,SUB-DISTRICT,Jagadhri,293,417788,223433,194355
06,071,00362,SUB-DISTRICT,Bilaspur,176,159953,84420,75533
06,071,00363,SUB-DISTRICT,Chhachhrauli,142,163635,86104,77531
06,072,00000,DISTRICT,Kurukshetra,407,685430,361020,324410
06,072,00364,SUB-DISTRICT,Shahbad,63,87569,46283,41286
06,072,00365,SUB-DISTRICT,Pehowa,106,202728,106407,96321
06,072,00366,SUB-DISTRICT,Thanesar,238,395133,208330,186803
06,073,00000,DISTRICT,Kaithal,267,838293,445931,392362
06,073,00367,SUB-DISTRICT,Guhla,87,156299,82006,74293
06,073,00368,SUB-DISTRICT,Kaithal,128,478398,255597,222801
06,073,00369,SUB-DISTRICT,Fatehpur Pundri,52,203596,108328,95268
06,074,00000,DISTRICT,Karnal,417,1050514,557110,493404
06,074,00370,SUB-DISTRICT,Nilokheri,76,163219,86167,77052
06,074,00371,SUB-DISTRICT,Indri,106,145106,76674,68432
06,074,00372,SUB-DISTRICT,Karnal,130,385828,205154,180674
06,074,00373,SUB-DISTRICT,Assandh,54,206079,109350,96729
06,074,00374,SUB-DISTRICT,Gharaunda,51,150282,79765,70517
06,075,00000,DISTRICT,Panipat,176,650352,349642,300710
06,075,00375,SUB-DISTRICT,Panipat,75,276259,148063,128196
06,075,00376,SUB-DISTRICT,Israna,27,108196,57882,50314
06,075,00377,SUB-DISTRICT,Samalkha,74,265897,143697,122200
06,076,00000,DISTRICT,Sonipat,319,996637,538750,457887
06,076,00378,SUB-DISTRICT,Gohana,81,306326,164182,142144
06,076,00379,SUB-DISTRICT,Ganaur,60,171286,93456,77830
06,076,00380,SUB-DISTRICT,Sonipat,135,383181,207546,175635
06,076,00381,SUB-DISTRICT,Kharkhoda,43,135844,73566,62278
06,077,00000,DISTRICT,Jind,302,1028569,550519,478050
06,077,00382,SUB-DISTRICT,Narwana,107,405416,216101,189315
06,077,00383,SUB-DISTRICT,Jind,96,309202,165870,143332
06,077,00384,SUB-DISTRICT,Julana,29,100653,54123,46530
06,077,00385,SUB-DISTRICT,Safidon,70,213298,114425,98873
06,078,00000,DISTRICT,Fatehabad,245,762423,400814,361609
06,078,00386,SUB-DISTRICT,Ratia,66,142398,74160,68238
06,078,00387,SUB-DISTRICT,Tohana,84,192105,101218,90887
06,078,00388,SUB-DISTRICT,Fatehabad,95,427920,225436,202484
06,079,00000,DISTRICT,Sirsa,327,975941,514177,461764
06,079,00389,SUB-DISTRICT,Dabwali,70,217056,114127,102929
06,079,00390,SUB-DISTRICT,Sirsa,181,512701,270450,242251
06,079,00391,SUB-DISTRICT,Rania,46,150541,79306,71235
06,079,00392,SUB-DISTRICT,Ellenabad,30,95643,50294,45349
06,080,00000,DISTRICT,Hisar,268,1190443,634139,556304
06,080,00393,SUB-DISTRICT,Adampur,28,121421,64324,57097
06,080,00394,SUB-DISTRICT,Hisar,148,645364,342554,302810
06,080,00395,SUB-DISTRICT,Narnaund,30,123638,66470,57168
06,080,00396,SUB-DISTRICT,Hansi,62,300020,160791,139229
06,081,00000,DISTRICT,Bhiwani,442,1313123,696212,616911
06,081,00397,SUB-DISTRICT,Bawani Khera,19,106746,56427,50319
06,081,00398,SUB-DISTRICT,Bhiwani,82,357641,191355,166286
06,081,00399,SUB-DISTRICT,Tosham,60,175907,93148,82759
06,081,00400,SUB-DISTRICT,Siwani,33,81040,42776,38264
06,081,00401,SUB-DISTRICT,Loharu,78,145850,76510,69340
06,081,00402,SUB-DISTRICT,Dadri,116,327855,173205,154650
06,081,00403,SUB-DISTRICT,Badhra,54,118084,62791,55293
06,082,00000,DISTRICT,Rohtak,136,615040,332034,283006
06,082,00404,SUB-DISTRICT,Maham,31,182566,98571,83995
06,082,00405,SUB-DISTRICT,Rohtak,83,329211,177499,151712
06,082,00406,SUB-DISTRICT,Sampla,22,103263,55964,47299
06,083,00000,DISTRICT,Jhajjar,247,715066,384219,330847
06,083,00407,SUB-DISTRICT,Beri,38,139857,74858,64999
06,083,00408,SUB-DISTRICT,Bahadurgarh,60,226074,122895,103179
06,083,00409,SUB-DISTRICT,Jhajjar,97,208862,110998,97864
06,083,00410,SUB-DISTRICT,Matenhail,52,140273,75468,64805
06,084,00000,DISTRICT,Mahendragarh,369,789233,416358,372875
06,084,00411,SUB-DISTRICT,Mahendragarh,149,362264,190767,171497
06,084,00412,SUB-DISTRICT,Narnaul,220,426969,225591,201378
06,085,00000,DISTRICT,Rewari,389,666902,349710,317192
06,085,00413,SUB-DISTRICT,Kosli,52,117440,60949,56491
06,085,00414,SUB-DISTRICT,Rewari,258,436188,228883,207305
06,085,00415,SUB-DISTRICT,Bawal,79,113274,59878,53396
06,086,00000,DISTRICT,Gurgaon,229,472179,251462,220717
06,086,00416,SUB-DISTRICT,Pataudi,53,78688,41060,37628
06,086,00417,SUB-DISTRICT,Gurgaon,32,67331,36026,31305
06,086,00418,SUB-DISTRICT,Farrukhnagar,49,121335,63814,57521
06,086,00419,SUB-DISTRICT,Manesar,34,93158,51159,41999
06,086,00420,SUB-DISTRICT,Sohna,61,111667,59403,52264
06,087,00000,DISTRICT,Mewat ,412,965157,506086,459071
06,087,00421,SUB-DISTRICT,Taoru,79,138172,72575,65597
06,087,00422,SUB-DISTRICT,Nuh,103,265114,139678,125436
06,087,00423,SUB-DISTRICT,Ferozepur Jhirka,143,307239,160615,146624
06,087,00424,SUB-DISTRICT,Punahana,87,254632,133218,121414
06,088,00000,DISTRICT,Faridabad,144,370878,198103,172775
06,088,00425,SUB-DISTRICT,Faridabad,62,160275,86260,74015
06,088,00426,SUB-DISTRICT,Ballabgarh,82,210603,111843,98760
06,089,00000,DISTRICT,Palwal ,268,806164,428907,377257
06,089,00427,SUB-DISTRICT,Palwal,143,345842,184610,161232
06,089,00428,SUB-DISTRICT,Hathin,79,254594,134538,120056
06,089,00429,SUB-DISTRICT,Hodal,46,205728,109759,95969
07,000,00000,STATE,NCT OF DELHI,103,419042,226321,192721
07,090,00000,DISTRICT,North West,48,213950,115680,98270
07,090,00430,SUB-DISTRICT,Narela,36,168739,91524,77215
07,090,00431,SUB-DISTRICT,Saraswati Vihar,12,45211,24156,21055
07,090,00432,SUB-DISTRICT,Model Town,0,0,0,0
07,091,00000,DISTRICT,North,2,17746,9546,8200
07,091,00433,SUB-DISTRICT,Civil Lines,2,17746,9546,8200
07,091,00434,SUB-DISTRICT,Sadar Bazar,0,0,0,0
07,091,00435,SUB-DISTRICT,Kotwali,0,0,0,0
07,092,00000,DISTRICT,North East,8,21527,11718,9809
07,092,00436,SUB-DISTRICT,Seelam Pur,8,21527,11718,9809
07,092,00437,SUB-DISTRICT,Shahdara,0,0,0,0
07,092,00438,SUB-DISTRICT,Seema Puri,0,0,0,0
07,093,00000,DISTRICT,East,1,3530,1861,1669
07,093,00439,SUB-DISTRICT,Gandhi Nagar,0,0,0,0
07,093,00440,SUB-DISTRICT,Vivek Vihar,0,0,0,0
07,093,00441,SUB-DISTRICT,Preet Vihar,1,3530,1861,1669
07,094,00000,DISTRICT,New Delhi,0,0,0,0
07,094,00442,SUB-DISTRICT,Connaught Place,0,0,0,0
07,094,00443,SUB-DISTRICT,Chanakya Puri,0,0,0,0
07,094,00444,SUB-DISTRICT,Parliament Street,0,0,0,0
07,095,00000,DISTRICT,Central,0,0,0,0
07,095,00445,SUB-DISTRICT,Darya Ganj,0,0,0,0
07,095,00446,SUB-DISTRICT,Pahar Ganj,0,0,0,0
07,095,00447,SUB-DISTRICT,Karol Bagh,0,0,0,0
07,096,00000,DISTRICT,West,2,6420,3355,3065
07,096,00448,SUB-DISTRICT,Patel Nagar,0,0,0,0
07,096,00449,SUB-DISTRICT,Rajouri Garden,0,0,0,0
07,096,00450,SUB-DISTRICT,Punjabi Bagh,2,6420,3355,3065
07,097,00000,DISTRICT,South West,39,143676,77342,66334
07,097,00451,SUB-DISTRICT,Najafgarh,39,143676,77342,66334
07,097,00452,SUB-DISTRICT,Delhi Cantonment,0,0,0,0
07,097,00453,SUB-DISTRICT,Vasant Vihar,0,0,0,0
07,098,00000,DISTRICT,South,3,12193,6819,5374
07,098,00454,SUB-DISTRICT,Hauz Khas,3,12193,6819,5374
07,098,00455,SUB-DISTRICT,Defence Colony,0,0,0,0
07,098,00456,SUB-DISTRICT,Kalkaji,0,0,0,0
08,000,00000,STATE,RAJASTHAN,43264,51500352,26641747,24858605
08,099,00000,DISTRICT,Ganganagar ,2855,1433736,758269,675467
08,099,00457,SUB-DISTRICT,Karanpur,205,111571,58524,53047
08,099,00458,SUB-DISTRICT,Ganganagar,299,231726,122422,109304
08,099,00459,SUB-DISTRICT,Sadulshahar,201,122132,65670,56462
08,099,00460,SUB-DISTRICT,Padampur,242,134303,70486,63817
08,099,00461,SUB-DISTRICT,Raisinghnagar,378,168125,87853,80272
08,099,00462,SUB-DISTRICT,Anupgarh,398,153546,80721,72825
08,099,00463,SUB-DISTRICT,Gharsana,426,141840,74925,66915
08,099,00464,SUB-DISTRICT,Vijainagar,265,120048,63482,56566
08,099,00465,SUB-DISTRICT,Suratgarh,441,250445,134186,116259
08,100,00000,DISTRICT,Hanumangarh,1831,1424228,746887,677341
08,100,00466,SUB-DISTRICT,Sangaria,184,122524,64424,58100
08,100,00467,SUB-DISTRICT,Tibi,247,165217,86128,79089
08,100,00468,SUB-DISTRICT,Hanumangarh,392,273661,143675,129986
08,100,00469,SUB-DISTRICT,Pilibanga,291,178427,93906,84521
08,100,00470,SUB-DISTRICT,Rawatsar,306,169991,88812,81179
08,100,00471,SUB-DISTRICT,Nohar,208,264752,139091,125661
08,100,00472,SUB-DISTRICT,Bhadra,203,249656,130851,118805
08,101,00000,DISTRICT,Bikaner,857,1563553,821434,742119
08,101,00473,SUB-DISTRICT,Bikaner,108,256830,135199,121631
08,101,00474,SUB-DISTRICT,Poogal,56,67163,35567,31596
08,101,00475,SUB-DISTRICT,Lunkaransar,125,213627,111409,102218
08,101,00476,SUB-DISTRICT,Kolayat,209,251344,133015,118329
08,101,00477,SUB-DISTRICT,Nokha,145,374177,196589,177588
08,101,00478,SUB-DISTRICT,Khajuwala,54,76899,40662,36237
08,101,00479,SUB-DISTRICT,Chhatargarh,64,82488,43288,39200
08,101,00480,SUB-DISTRICT,Sridungargarh,96,241025,125705,115320
08,102,00000,DISTRICT,Churu,873,1463312,755028,708284
08,102,00481,SUB-DISTRICT,Taranagar,112,179191,93251,85940
08,102,00482,SUB-DISTRICT,Rajgarh,215,303389,157983,145406
08,102,00483,SUB-DISTRICT,Sardarshahar,173,286563,148669,137894
08,102,00484,SUB-DISTRICT,Churu,109,177564,89931,87633
08,102,00485,SUB-DISTRICT,Ratangarh,101,193516,98909,94607
08,102,00486,SUB-DISTRICT,Sujangarh,163,323089,166285,156804
08,103,00000,DISTRICT,Jhunjhunun,926,1647966,842718,805248
08,103,00487,SUB-DISTRICT,Jhunjhunun,271,328886,164506,164380
08,103,00488,SUB-DISTRICT,Chirawa,212,365083,186582,178501
08,103,00489,SUB-DISTRICT,Buhana,137,212033,110115,101918
08,103,00490,SUB-DISTRICT,Khetri,103,232184,121379,110805
08,103,00491,SUB-DISTRICT,Nawalgarh,109,244246,124306,119940
08,103,00492,SUB-DISTRICT,Udaipurwati,94,265534,135830,129704
08,104,00000,DISTRICT,Alwar,2021,3019728,1589508,1430220
08,104,00493,SUB-DISTRICT,Behror,176,312737,164380,148357
08,104,00494,SUB-DISTRICT,Mandawar,146,231628,121648,109980
08,104,00495,SUB-DISTRICT,Kotkasim,116,137339,71907,65432
08,104,00496,SUB-DISTRICT,Tijara,187,257436,135003,122433
08,104,00497,SUB-DISTRICT,Kishangarh Bas,108,150552,78288,72264
08,104,00498,SUB-DISTRICT,Ramgarh,177,243076,127039,116037
08,104,00499,SUB-DISTRICT,Alwar,195,355128,187403,167725
08,104,00500,SUB-DISTRICT,Bansur,147,263663,138905,124758
08,104,00501,SUB-DISTRICT,Thanagazi,163,233395,122907,110488
08,104,00502,SUB-DISTRICT,Rajgarh,249,330096,174921,155175
08,104,00503,SUB-DISTRICT,Lachhmangarh,205,277119,145947,131172
08,104,00504,SUB-DISTRICT,Kathumar,152,227559,121160,106399
08,105,00000,DISTRICT,Bharatpur,1432,2053363,1093357,960006
08,105,00505,SUB-DISTRICT,Pahari,132,198897,103529,95368
08,105,00506,SUB-DISTRICT,Kaman,113,165909,87262,78647
08,105,00507,SUB-DISTRICT,Nagar,164,216286,114149,102137
08,105,00508,SUB-DISTRICT,Deeg,124,181711,96814,84897
08,105,00509,SUB-DISTRICT,Nadbai,119,188725,100796,87929
08,105,00510,SUB-DISTRICT,Kumher,124,177801,94427,83374
08,105,00511,SUB-DISTRICT,Bharatpur,175,200177,106496,93681
08,105,00512,SUB-DISTRICT,Weir,148,240761,128849,111912
08,105,00513,SUB-DISTRICT,Bayana,182,225144,122692,102452
08,105,00514,SUB-DISTRICT,Rupbas,151,257952,138343,119609
08,106,00000,DISTRICT,Dhaulpur,801,959066,520930,438136
08,106,00515,SUB-DISTRICT,Baseri,194,226786,123327,103459
08,106,00516,SUB-DISTRICT,Bari,170,182929,100524,82405
08,106,00517,SUB-DISTRICT,Sepau,130,191079,102497,88582
08,106,00518,SUB-DISTRICT,Dhaulpur,195,228034,123657,104377
08,106,00519,SUB-DISTRICT,Rajakhera,112,130238,70925,59313
08,107,00000,DISTRICT,Karauli,851,1240143,668185,571958
08,107,00520,SUB-DISTRICT,Todabhim,148,228203,122525,105678
08,107,00521,SUB-DISTRICT,Nadoti,96,150898,80479,70419
08,107,00522,SUB-DISTRICT,Hindaun,160,318422,171569,146853
08,107,00523,SUB-DISTRICT,Karauli,206,266168,143984,122184
08,107,00524,SUB-DISTRICT,Mandrail,74,74600,40659,33941
08,107,00525,SUB-DISTRICT,Sapotra,167,201852,108969,92883
08,108,00000,DISTRICT,Sawai Madhopur,758,1069084,564592,504492
08,108,00526,SUB-DISTRICT,Gangapur,118,216553,115551,101002
08,108,00527,SUB-DISTRICT,Bamanwas,141,171648,91628,80020
08,108,00528,SUB-DISTRICT,Malarna Doongar,61,105732,55413,50319
08,108,00529,SUB-DISTRICT,Bonli,99,127441,67087,60354
08,108,00530,SUB-DISTRICT,Chauth Ka Barwara,66,97500,50627,46873
08,108,00531,SUB-DISTRICT,Sawai Madhopur,147,213771,111714,102057
08,108,00532,SUB-DISTRICT,Khandar,126,136439,72572,63867
08,109,00000,DISTRICT,Dausa,1079,1432616,751900,680716
08,109,00533,SUB-DISTRICT,Baswa,229,294214,154652,139562
08,109,00534,SUB-DISTRICT,Mahwa,161,227861,120859,107002
08,109,00535,SUB-DISTRICT,Sikrai,139,260484,136682,123802
08,109,00536,SUB-DISTRICT,Dausa,248,334977,175053,159924
08,109,00537,SUB-DISTRICT,Lalsot,302,315080,164654,150426
08,110,00000,DISTRICT,Jaipur,2126,3154331,1642924,1511407
08,110,00538,SUB-DISTRICT,Kotputli,144,364054,191713,172341
08,110,00539,SUB-DISTRICT,Viratnagar,100,145519,76272,69247
08,110,00540,SUB-DISTRICT,Shahpura,100,218450,114949,103501
08,110,00541,SUB-DISTRICT,Chomu,114,322857,167857,155000
08,110,00542,SUB-DISTRICT,Phulera (Hq.Sambhar),238,355132,184064,171068
08,110,00543,SUB-DISTRICT,Mauzamabad,148,213016,109983,103033
08,110,00544,SUB-DISTRICT,Phagi,169,191126,99226,91900
08,110,00545,SUB-DISTRICT,Sanganer,144,174893,90298,84595
08,110,00546,SUB-DISTRICT,Jaipur,72,128716,66785,61931
08,110,00547,SUB-DISTRICT,Amber,192,319630,166351,153279
08,110,00548,SUB-DISTRICT,Jamwa Ramgarh,233,295571,154444,141127
08,110,00549,SUB-DISTRICT,Bassi,206,235165,122194,112971
08,110,00550,SUB-DISTRICT,Chaksu,266,190202,98788,91414
08,111,00000,DISTRICT,Sikar,1162,2043427,1047469,995958
08,111,00551,SUB-DISTRICT,Fatehpur,127,180019,89988,90031
08,111,00552,SUB-DISTRICT,Lachhmangarh,170,267564,134790,132774
08,111,00553,SUB-DISTRICT,Sikar,201,399689,204580,195109
08,111,00554,SUB-DISTRICT,Danta Ramgarh,242,365356,186789,178567
08,111,00555,SUB-DISTRICT,Sri Madhopur,230,473462,244103,229359
08,111,00556,SUB-DISTRICT,Neem-Ka-Thana,192,357337,187219,170118
08,112,00000,DISTRICT,Nagaur,1575,2670539,1368771,1301768
08,112,00557,SUB-DISTRICT,Ladnu,99,187367,95217,92150
08,112,00558,SUB-DISTRICT,Didwana,189,343254,174495,168759
08,112,00559,SUB-DISTRICT,Jayal,139,269024,138528,130496
08,112,00560,SUB-DISTRICT,Nagaur,192,344603,177533,167070
08,112,00561,SUB-DISTRICT,Kheenvsar,92,192924,100077,92847
08,112,00562,SUB-DISTRICT,Merta,197,308254,158369,149885
08,112,00563,SUB-DISTRICT,Degana,199,289720,147146,142574
08,112,00564,SUB-DISTRICT,Parbatsar,117,208848,106441,102407
08,112,00565,SUB-DISTRICT,Makrana,134,205692,105560,100132
08,112,00566,SUB-DISTRICT,Nawa,217,320853,165405,155448
08,113,00000,DISTRICT,Jodhpur,1836,2422551,1260328,1162223
08,113,00567,SUB-DISTRICT,Phalodi,500,514646,270291,244355
08,113,00568,SUB-DISTRICT,Osian,264,465257,242164,223093
08,113,00569,SUB-DISTRICT,Bhopalgarh,160,320952,165645,155307
08,113,00570,SUB-DISTRICT,Jodhpur,133,239924,124447,115477
08,113,00571,SUB-DISTRICT,Shergarh,507,452134,237085,215049
08,113,00572,SUB-DISTRICT,Luni,170,221979,114403,107576
08,113,00573,SUB-DISTRICT,Bilara,102,207659,106293,101366
08,114,00000,DISTRICT,Jaisalmer,756,580894,312447,268447
08,114,00574,SUB-DISTRICT,Jaisalmer,338,199766,108579,91187
08,114,00575,SUB-DISTRICT,Pokaran,298,280108,148854,131254
08,114,00576,SUB-DISTRICT,Fatehgarh,120,101020,55014,46006
08,115,00000,DISTRICT,Barmer,2452,2421914,1273249,1148665
08,115,00577,SUB-DISTRICT,Sheo,298,237080,127247,109833
08,115,00578,SUB-DISTRICT,Baytoo,340,253350,132783,120567
08,115,00579,SUB-DISTRICT,Pachpadra,277,348288,181314,166974
08,115,00580,SUB-DISTRICT,Siwana,128,272560,142442,130118
08,115,00581,SUB-DISTRICT,Gudha Malani,522,447398,233722,213676
08,115,00582,SUB-DISTRICT,Barmer,295,269893,143613,126280
08,115,00583,SUB-DISTRICT,Ramsar,166,108001,56709,51292
08,115,00584,SUB-DISTRICT,Chohtan,426,485344,255419,229925
08,116,00000,DISTRICT,Jalor,791,1676975,857619,819356
08,116,00585,SUB-DISTRICT,Sayla,51,176682,90131,86551
08,116,00586,SUB-DISTRICT,Ahore,134,222775,110392,112383
08,116,00587,SUB-DISTRICT,Jalor,73,210342,107070,103272
08,116,00588,SUB-DISTRICT,Bhinmal,104,254621,128388,126233
08,116,00589,SUB-DISTRICT,Bagora,58,151141,78110,73031
08,116,00590,SUB-DISTRICT,Sanchore,276,454583,236942,217641
08,116,00591,SUB-DISTRICT,Raniwara,95,206831,106586,100245
08,117,00000,DISTRICT,Sirohi,470,827692,424252,403440
08,117,00592,SUB-DISTRICT,Sheoganj,70,114276,58440,55836
08,117,00593,SUB-DISTRICT,Sirohi,84,141122,71175,69947
08,117,00594,SUB-DISTRICT,Pindwara,107,221887,114090,107797
08,117,00595,SUB-DISTRICT,Abu Road,82,136676,69911,66765
08,117,00596,SUB-DISTRICT,Reodar,127,213731,110636,103095
08,118,00000,DISTRICT,Pali,1017,1577567,787559,790008
08,118,00597,SUB-DISTRICT,Jaitaran,108,204155,102462,101693
08,118,00598,SUB-DISTRICT,Raipur,137,205254,103005,102249
08,118,00599,SUB-DISTRICT,Sojat,123,165359,82056,83303
08,118,00600,SUB-DISTRICT,Rohat,79,120963,62111,58852
08,118,00601,SUB-DISTRICT,Pali,101,138311,69627,68684
08,118,00602,SUB-DISTRICT,Marwar Junction,156,186974,92083,94891
08,118,00603,SUB-DISTRICT,Desuri,136,193067,94829,98238
08,118,00604,SUB-DISTRICT,Sumerpur,66,144303,71493,72810
08,118,00605,SUB-DISTRICT,Bali,111,219181,109893,109288
08,119,00000,DISTRICT,Ajmer,1099,1547642,789397,758245
08,119,00606,SUB-DISTRICT,Kishangarh,171,263345,135114,128231
08,119,00607,SUB-DISTRICT,Ajmer,85,220616,113633,106983
08,119,00608,SUB-DISTRICT,Peesangan,64,127803,65075,62728
08,119,00609,SUB-DISTRICT,Beawar,222,191783,96466,95317
08,119,00610,SUB-DISTRICT,Masuda,158,185713,95202,90511
08,119,00611,SUB-DISTRICT,Nasirabad,90,136682,69889,66793
08,119,00612,SUB-DISTRICT,Bhinay,95,126466,64154,62312
08,119,00613,SUB-DISTRICT,Sarwar,112,134366,68268,66098
08,119,00614,SUB-DISTRICT,Kekri,102,160868,81596,79272
08,120,00000,DISTRICT,Tonk,1116,1103603,568045,535558
08,120,00615,SUB-DISTRICT,Malpura,153,204881,105020,99861
08,120,00616,SUB-DISTRICT,Peeplu,118,117644,60740,56904
08,120,00617,SUB-DISTRICT,Niwai,204,195187,101301,93886
08,120,00618,SUB-DISTRICT,Tonk,124,121514,62592,58922
08,120,00619,SUB-DISTRICT,Todaraisingh,139,123311,62849,60462
08,120,00620,SUB-DISTRICT,Deoli,169,192343,98637,93706
08,120,00621,SUB-DISTRICT,Uniara,209,148723,76906,71817
08,121,00000,DISTRICT,Bundi,867,888205,461734,426471
08,121,00622,SUB-DISTRICT,Hindoli,184,219968,114242,105726
08,121,00623,SUB-DISTRICT,Nainwa,190,176585,92236,84349
08,121,00624,SUB-DISTRICT,Indragarh,116,87066,45457,41609
08,121,00625,SUB-DISTRICT,Keshoraipatan,112,108612,56203,52409
08,121,00626,SUB-DISTRICT,Bundi,265,295974,153596,142378
08,122,00000,DISTRICT,Bhilwara,1790,1895869,955378,940491
08,122,00627,SUB-DISTRICT,Asind,209,237519,118766,118753
08,122,00628,SUB-DISTRICT,Hurda,82,111428,56836,54592
08,122,00629,SUB-DISTRICT,Shahpura,162,176700,89868,86832
08,122,00630,SUB-DISTRICT,Banera  ,87,123714,62298,61416
08,122,00631,SUB-DISTRICT,Mandal  ,212,235640,115728,119912
08,122,00632,SUB-DISTRICT,Raipur,89,97869,48256,49613
08,122,00633,SUB-DISTRICT,Sahara,103,116309,57267,59042
08,122,00634,SUB-DISTRICT,Bhilwara,143,186600,94360,92240
08,122,00635,SUB-DISTRICT,Kotri,180,174701,88901,85800
08,122,00636,SUB-DISTRICT,Jahazpur,228,197187,101513,95674
08,122,00637,SUB-DISTRICT,Mandalgarh,183,162859,83228,79631
08,122,00638,SUB-DISTRICT,Beejoliya,112,75343,38357,36986
08,123,00000,DISTRICT,Rajsamand,1037,972777,486960,485817
08,123,00639,SUB-DISTRICT,Bhim,140,159455,80490,78965
08,123,00640,SUB-DISTRICT,Deogarh,132,93119,46323,46796
08,123,00641,SUB-DISTRICT,Amet,151,95014,47708,47306
08,123,00642,SUB-DISTRICT,Kumbhalgarh,167,144231,70366,73865
08,123,00643,SUB-DISTRICT,Rajsamand,140,150872,76324,74548
08,123,00644,SUB-DISTRICT,Railmagra,95,131800,66260,65540
08,123,00645,SUB-DISTRICT,Nathdwara,212,198286,99489,98797
08,124,00000,DISTRICT,Dungarpur,972,1299809,651046,648763
08,124,00646,SUB-DISTRICT,Dungarpur,305,447717,224841,222876
08,124,00647,SUB-DISTRICT,Aspur,171,224243,112422,111821
08,124,00648,SUB-DISTRICT,Sagwara,244,309086,152622,156464
08,124,00649,SUB-DISTRICT,Simalwara,252,318763,161161,157602
08,125,00000,DISTRICT,Banswara,1485,1669864,842767,827097
08,125,00650,SUB-DISTRICT,Ghatol,238,287101,144092,143009
08,125,00651,SUB-DISTRICT,Garhi  ,206,282802,143067,139735
08,125,00652,SUB-DISTRICT,Banswara,334,357570,180919,176651
08,125,00653,SUB-DISTRICT,Bagidora,308,373825,189168,184657
08,125,00654,SUB-DISTRICT,Kushalgarh,399,368566,185521,183045
08,126,00000,DISTRICT,Chittaurgarh,1581,1259074,636415,622659
08,126,00655,SUB-DISTRICT,Rashmi,87,88670,43954,44716
08,126,00656,SUB-DISTRICT,Gangrar,131,103933,52560,51373
08,126,00657,SUB-DISTRICT,Begun,217,114635,57952,56683
08,126,00658,SUB-DISTRICT,Rawatbhata,164,102429,53089,49340
08,126,00659,SUB-DISTRICT,Chittaurgarh,219,184005,93182,90823
08,126,00660,SUB-DISTRICT,Kapasan,191,178471,89522,88949
08,126,00661,SUB-DISTRICT,Dungla,103,104607,52753,51854
08,126,00662,SUB-DISTRICT,Bhadesar,163,123930,62957,60973
08,126,00663,SUB-DISTRICT,Nimbahera,158,157841,79895,77946
08,126,00664,SUB-DISTRICT,Bari Sadri,148,100553,50551,50002
08,127,00000,DISTRICT,Kota,805,774410,401331,373079
08,127,00665,SUB-DISTRICT,Pipalda,167,179800,93118,86682
08,127,00666,SUB-DISTRICT,Digod,164,168734,87493,81241
08,127,00667,SUB-DISTRICT,Ladpura,117,117838,60881,56957
08,127,00668,SUB-DISTRICT,Ramganj Mandi,146,143644,74781,68863
08,127,00669,SUB-DISTRICT,Sangod,211,164394,85058,79336
08,128,00000,DISTRICT,Baran,1114,968541,502228,466313
08,128,00670,SUB-DISTRICT,Mangrol,73,81890,42524,39366
08,128,00671,SUB-DISTRICT,Antah,79,87661,45440,42221
08,128,00672,SUB-DISTRICT,Baran,90,95563,49718,45845
08,128,00673,SUB-DISTRICT,Atru,141,122309,63473,58836
08,128,00674,SUB-DISTRICT,Kishanganj,190,166864,85961,80903
08,128,00675,SUB-DISTRICT,Shahbad,177,142061,73716,68345
08,128,00676,SUB-DISTRICT,Chhabra,188,120144,62823,57321
08,128,00677,SUB-DISTRICT,Chhipabarod,176,152049,78573,73476
08,129,00000,DISTRICT,Jhalawar,1488,1181838,606533,575305
08,129,00678,SUB-DISTRICT,Khanpur,193,159345,82830,76515
08,129,00679,SUB-DISTRICT,Jhalrapatan,353,242470,124380,118090
08,129,00680,SUB-DISTRICT,Aklera,232,152331,78355,73976
08,129,00681,SUB-DISTRICT,Manohar Thana,188,131783,67329,64454
08,129,00682,SUB-DISTRICT,Pachpahar,133,137135,70046,67089
08,129,00683,SUB-DISTRICT,Pirawa,205,199872,102444,97428
08,129,00684,SUB-DISTRICT,Gangdhar,184,158902,81149,77753
08,130,00000,DISTRICT,Udaipur,2471,2459994,1251316,1208678
08,130,00685,SUB-DISTRICT,Mavli,178,221333,112497,108836
08,130,00686,SUB-DISTRICT,Gogunda,232,206197,105190,101007
08,130,00687,SUB-DISTRICT,Kotra,262,230532,116764,113768
08,130,00688,SUB-DISTRICT,Jhadol,283,249297,126124,123173
08,130,00689,SUB-DISTRICT,Girwa,325,410114,209419,200695
08,130,00690,SUB-DISTRICT,Vallabhnagar,300,240562,122619,117943
08,130,00691,SUB-DISTRICT,Lasadiya,113,91229,46364,44865
08,130,00692,SUB-DISTRICT,Salumbar,268,231912,117554,114358
08,130,00693,SUB-DISTRICT,Sarada,191,215858,110022,105836
08,130,00694,SUB-DISTRICT,Rishabhdeo,125,163764,83447,80317
08,130,00695,SUB-DISTRICT,Kherwara,194,199196,101316,97880
08,131,00000,DISTRICT,Pratapgarh,970,796041,401171,394870
08,131,00696,SUB-DISTRICT,Dhariawad,167,178504,88752,89752
08,131,00697,SUB-DISTRICT,Peepalkhoont,204,154063,77910,76153
08,131,00698,SUB-DISTRICT,Chhoti Sadri,147,115717,58704,57013
08,131,00699,SUB-DISTRICT,Pratapgarh,272,206734,104955,101779
08,131,00700,SUB-DISTRICT,Arnod,180,141023,70850,70173
09,000,00000,STATE,UTTAR PRADESH,97814,155317278,80992995,74324283
09,132,00000,DISTRICT,Saharanpur,1243,2399856,1269803,1130053
09,132,00701,SUB-DISTRICT,Behat,263,484672,255338,229334
09,132,00702,SUB-DISTRICT,Saharanpur,319,638422,336615,301807
09,132,00703,SUB-DISTRICT,Nakur,334,551905,292726,259179
09,132,00704,SUB-DISTRICT,Deoband,178,411571,218868,192703
09,132,00705,SUB-DISTRICT,Rampur Maniharan,149,313286,166256,147030
09,133,00000,DISTRICT,Muzaffarnagar,880,2952200,1565004,1387196
09,133,00706,SUB-DISTRICT,Kairana,149,416594,221685,194909
09,133,00707,SUB-DISTRICT,Shamli,134,470882,251293,219589
09,133,00708,SUB-DISTRICT,Muzaffarnagar,235,861606,455802,405804
09,133,00709,SUB-DISTRICT,Budhana,110,443529,236360,207169
09,133,00710,SUB-DISTRICT,Khatauli,121,329802,173818,155984
09,133,00711,SUB-DISTRICT,Jansath,131,429787,226046,203741
09,134,00000,DISTRICT,Bijnor,2186,2757401,1438412,1318989
09,134,00712,SUB-DISTRICT,Najibabad,402,521247,272495,248752
09,134,00713,SUB-DISTRICT,Bijnor,374,451657,237985,213672
09,134,00714,SUB-DISTRICT,Nagina,352,372565,192475,180090
09,134,00715,SUB-DISTRICT,Dhampur,658,836723,435289,401434
09,134,00716,SUB-DISTRICT,Chandpur,400,575209,300168,275041
09,135,00000,DISTRICT,Moradabad,1550,3198383,1680022,1518361
09,135,00717,SUB-DISTRICT,Thakurdwara,241,460305,241272,219033
09,135,00718,SUB-DISTRICT,Kanth,155,247405,129313,118092
09,135,00719,SUB-DISTRICT,Moradabad,267,674655,353501,321154
09,135,00720,SUB-DISTRICT,Bilari,300,587617,308311,279306
09,135,00721,SUB-DISTRICT,Sambhal,363,746061,391713,354348
09,135,00722,SUB-DISTRICT,Chandausi,224,482340,255912,226428
09,136,00000,DISTRICT,Rampur,1108,1747172,916878,830294
09,136,00723,SUB-DISTRICT,Suar,183,293514,153304,140210
09,136,00724,SUB-DISTRICT,Tanda,166,292528,153146,139382
09,136,00725,SUB-DISTRICT,Bilaspur,207,216589,113531,103058
09,136,00726,SUB-DISTRICT,Rampur,166,321621,168571,153050
09,136,00727,SUB-DISTRICT,Shahabad ,189,316794,166946,149848
09,136,00728,SUB-DISTRICT,Milak ,197,306126,161380,144746
09,137,00000,DISTRICT,Jyotiba Phule Nagar,959,1381508,724539,656969
09,137,00729,SUB-DISTRICT,Dhanaura,288,351942,185079,166863
09,137,00730,SUB-DISTRICT,Amroha,365,519380,271764,247616
09,137,00731,SUB-DISTRICT,Hasanpur,306,510186,267696,242490
09,138,00000,DISTRICT,Meerut,604,1684507,894920,789587
09,138,00732,SUB-DISTRICT,Sardhana,128,457376,242582,214794
09,138,00733,SUB-DISTRICT,Mawana,268,585122,311187,273935
09,138,00734,SUB-DISTRICT,Meerut,208,642009,341151,300858
09,139,00000,DISTRICT,Baghpat,290,1028023,553807,474216
09,139,00735,SUB-DISTRICT,Baraut,139,562114,303765,258349
09,139,00736,SUB-DISTRICT,Baghpat,103,329593,176900,152693
09,139,00737,SUB-DISTRICT,Khekada,48,136316,73142,63174
09,140,00000,DISTRICT,Ghaziabad,511,1519098,808222,710876
09,140,00738,SUB-DISTRICT,Modinagar,111,296176,158479,137697
09,140,00739,SUB-DISTRICT,Ghaziabad,72,294358,157951,136407
09,140,00740,SUB-DISTRICT,Hapur,202,601309,318819,282490
09,140,00741,SUB-DISTRICT,Garhmukteshwar,126,327255,172973,154282
09,141,00000,DISTRICT,Gautam Buddha Nagar,304,673806,359605,314201
09,141,00742,SUB-DISTRICT,Dadri,108,326999,173699,153300
09,141,00743,SUB-DISTRICT,Gautam Buddha Nagar,113,184304,98340,85964
09,141,00744,SUB-DISTRICT,Jewar,83,162503,87566,74937
09,142,00000,DISTRICT,Bulandshahr ,1174,2631742,1390490,1241252
09,142,00745,SUB-DISTRICT,Sikandrabad,136,294858,157275,137583
09,142,00746,SUB-DISTRICT,Bulandshahr,239,555629,293503,262126
09,142,00747,SUB-DISTRICT,Siana,169,423348,222255,201093
09,142,00748,SUB-DISTRICT,Anupshahr,125,259380,136609,122771
09,142,00749,SUB-DISTRICT,Debai,146,370802,195351,175451
09,142,00750,SUB-DISTRICT,Shikarpur,173,365144,193202,171942
09,142,00751,SUB-DISTRICT,Khurja ,186,362581,192295,170286
09,143,00000,DISTRICT,Aligarh,1170,2456698,1308923,1147775
09,143,00752,SUB-DISTRICT,Khair,174,373088,199009,174079
09,143,00753,SUB-DISTRICT,Gabhana,157,302916,160951,141965
09,143,00754,SUB-DISTRICT,Atrauli,292,660633,351810,308823
09,143,00755,SUB-DISTRICT,Koil,361,751904,400051,351853
09,143,00756,SUB-DISTRICT,Iglas,186,368157,197102,171055
09,144,00000,DISTRICT,Mahamaya Nagar,655,1232015,659814,572201
09,144,00757,SUB-DISTRICT,Sasni,115,210991,112618,98373
09,144,00758,SUB-DISTRICT,Sikandra Rao ,158,330023,176429,153594
09,144,00759,SUB-DISTRICT,Hathras,248,356528,191017,165511
09,144,00760,SUB-DISTRICT,Sadabad,134,334473,179750,154723
09,145,00000,DISTRICT,Mathura,730,1791191,962028,829163
09,145,00761,SUB-DISTRICT,Chhata,165,449536,242564,206972
09,145,00762,SUB-DISTRICT,Mat,201,430136,230612,199524
09,145,00763,SUB-DISTRICT,Mahavan,148,296444,159351,137093
09,145,00764,SUB-DISTRICT,Mathura,216,615075,329501,285574
09,146,00000,DISTRICT,Agra,893,2394602,1285184,1109418
09,146,00765,SUB-DISTRICT,Etmadpur,105,336919,180766,156153
09,146,00766,SUB-DISTRICT,Agra,105,412425,220598,191827
09,146,00767,SUB-DISTRICT,Kiraoli,164,411721,220194,191527
09,146,00768,SUB-DISTRICT,Kheragarh,149,433764,234409,199355
09,146,00769,SUB-DISTRICT,Fatehabad,163,404170,217536,186634
09,146,00770,SUB-DISTRICT,Bah,207,395603,211681,183922
09,147,00000,DISTRICT,Firozabad,790,1664987,891872,773115
09,147,00771,SUB-DISTRICT,Tundla,95,296583,159454,137129
09,147,00772,SUB-DISTRICT,Firozabad,148,351868,189610,162258
09,147,00773,SUB-DISTRICT,Jasrana ,267,488400,260164,228236
09,147,00774,SUB-DISTRICT,Shikohabad ,280,528136,282644,245492
09,148,00000,DISTRICT,Mainpuri,820,1580087,842374,737713
09,148,00775,SUB-DISTRICT,Mainpuri,245,541385,288211,253174
09,148,00776,SUB-DISTRICT,Karhal,185,304017,162480,141537
09,148,00777,SUB-DISTRICT,Bhogaon ,390,734685,391683,343002
09,149,00000,DISTRICT,Budaun,1785,3037301,1630376,1406925
09,149,00778,SUB-DISTRICT,Gunnaur ,307,502934,270584,232350
09,149,00779,SUB-DISTRICT,Bisauli ,276,522853,278954,243899
09,149,00780,SUB-DISTRICT,Bilsi,201,369974,197295,172679
09,149,00781,SUB-DISTRICT,Sahaswan,234,323625,173502,150123
09,149,00782,SUB-DISTRICT,Budaun,373,747897,400886,347011
09,149,00783,SUB-DISTRICT,Dataganj,394,570018,309155,260863
09,150,00000,DISTRICT,Bareilly,1855,2879950,1530356,1349594
09,150,00784,SUB-DISTRICT,Baheri,385,540473,284458,256015
09,150,00785,SUB-DISTRICT,Meerganj ,217,404416,214687,189729
09,150,00786,SUB-DISTRICT,Aonla ,326,605703,324473,281230
09,150,00787,SUB-DISTRICT,Bareilly ,301,531985,281505,250480
09,150,00788,SUB-DISTRICT,Nawabganj ,297,412736,218425,194311
09,150,00789,SUB-DISTRICT,Faridpur ,329,384637,206808,177829
09,151,00000,DISTRICT,Pilibhit,1295,1679592,886789,792803
09,151,00790,SUB-DISTRICT,Pilibhit ,424,596311,312324,283987
09,151,00791,SUB-DISTRICT,Bisalpur,426,535262,285309,249953
09,151,00792,SUB-DISTRICT,Puranpur,445,548019,289156,258863
09,152,00000,DISTRICT,Shahjahanpur,2088,2412446,1293714,1118732
09,152,00793,SUB-DISTRICT,Powayan,671,628030,332790,295240
09,152,00794,SUB-DISTRICT,Tilhar,567,628076,337906,290170
09,152,00795,SUB-DISTRICT,Shahjahanpur,476,612617,327334,285283
09,152,00796,SUB-DISTRICT,Jalalabad,374,543723,295684,248039
09,153,00000,DISTRICT,Kheri,1706,3560208,1880679,1679529
09,153,00797,SUB-DISTRICT,Nighasan,108,387681,203385,184296
09,153,00798,SUB-DISTRICT,Palia,145,295379,154657,140722
09,153,00799,SUB-DISTRICT,Gola Gokaran Nath,277,618329,325421,292908
09,153,00800,SUB-DISTRICT,Mohammdi,510,746691,397376,349315
09,153,00801,SUB-DISTRICT,Lakhimpur,472,948691,500490,448201
09,153,00802,SUB-DISTRICT,Dhaurahara,194,563437,299350,264087
09,154,00000,DISTRICT,Sitapur,2317,3953208,2098123,1855085
09,154,00803,SUB-DISTRICT,Misrikh,586,886482,473449,413033
09,154,00804,SUB-DISTRICT,Sitapur,414,631901,334703,297198
09,154,00805,SUB-DISTRICT,Laharpur ,320,665377,351948,313429
09,154,00806,SUB-DISTRICT,Biswan,341,694749,367533,327216
09,154,00807,SUB-DISTRICT,Mahmudabad,341,530558,282045,248513
09,154,00808,SUB-DISTRICT,Sidhauli,315,544141,288445,255696
09,155,00000,DISTRICT,Hardoi,1907,3551039,1906147,1644892
09,155,00809,SUB-DISTRICT,Shahabad,418,644969,345697,299272
09,155,00810,SUB-DISTRICT,Sawayajpur,318,464960,252154,212806
09,155,00811,SUB-DISTRICT,Hardoi ,443,986548,531063,455485
09,155,00812,SUB-DISTRICT,Bilgram,312,555615,297149,258466
09,155,00813,SUB-DISTRICT,Sandila ,416,898947,480084,418863
09,156,00000,DISTRICT,Unnao,1693,2576721,1351897,1224824
09,156,00814,SUB-DISTRICT,Safipur,376,610960,323864,287096
09,156,00815,SUB-DISTRICT,Hasanganj ,485,663714,349891,313823
09,156,00816,SUB-DISTRICT,Unnao,274,555655,293273,262382
09,156,00817,SUB-DISTRICT,Purwa ,258,419588,218441,201147
09,156,00818,SUB-DISTRICT,Bighapur,300,326804,166428,160376
09,157,00000,DISTRICT,Lucknow,803,1550842,813752,737090
09,157,00819,SUB-DISTRICT,Malihabad,185,350635,183896,166739
09,157,00820,SUB-DISTRICT,Bakshi Ka Talab,185,284626,149737,134889
09,157,00821,SUB-DISTRICT,Lucknow,204,468885,246024,222861
09,157,00822,SUB-DISTRICT,Mohanlalganj ,229,446696,234095,212601
09,158,00000,DISTRICT,Rae Bareli,1733,3097564,1592449,1505115
09,158,00823,SUB-DISTRICT,Maharajganj,203,414470,214606,199864
09,158,00824,SUB-DISTRICT,Tiloi,198,475317,243452,231865
09,158,00825,SUB-DISTRICT,Rae Bareli ,340,639831,330780,309051
09,158,00826,SUB-DISTRICT,Lalganj ,333,498136,257163,240973
09,158,00827,SUB-DISTRICT,Dalmau ,193,282766,145333,137433
09,158,00828,SUB-DISTRICT,Unchahar,209,313852,160873,152979
09,158,00829,SUB-DISTRICT,Salon,257,473192,240242,232950
09,159,00000,DISTRICT,Farrukhabad,872,1469019,785301,683718
09,159,00830,SUB-DISTRICT,Kaimganj,382,592932,317806,275126
09,159,00831,SUB-DISTRICT,Amritpur,136,186183,100390,85793
09,159,00832,SUB-DISTRICT,Farrukhabad ,354,689904,367105,322799
09,160,00000,DISTRICT,Kannauj,688,1375775,734245,641530
09,160,00833,SUB-DISTRICT,Chhibramau,321,596851,317380,279471
09,160,00834,SUB-DISTRICT,Kannauj,203,369601,197354,172247
09,160,00835,SUB-DISTRICT,Tirwa,164,409323,219511,189812
09,161,00000,DISTRICT,Etawah,686,1215511,652740,562771
09,161,00836,SUB-DISTRICT,Jaswantnagar,99,186514,99403,87111
09,161,00837,SUB-DISTRICT,Saifai,59,95063,50980,44083
09,161,00838,SUB-DISTRICT,Etawah,192,323004,173365,149639
09,161,00839,SUB-DISTRICT,Bharthana,231,464103,248924,215179
09,161,00840,SUB-DISTRICT,Chakarnagar,105,146827,80068,66759
09,162,00000,DISTRICT,Auraiya,769,1145323,616494,528829
09,162,00841,SUB-DISTRICT,Bidhuna,399,637155,341758,295397
09,162,00842,SUB-DISTRICT,Auraiya ,370,508168,274736,233432
09,163,00000,DISTRICT,Kanpur Dehat,966,1622761,871508,751253
09,163,00843,SUB-DISTRICT,Rasulabad ,170,300270,161846,138424
09,163,00844,SUB-DISTRICT,Derapur,138,248626,133727,114899
09,163,00845,SUB-DISTRICT,Akbarpur ,267,477203,255680,221523
09,163,00846,SUB-DISTRICT,Bhognipur,202,331488,177509,153979
09,163,00847,SUB-DISTRICT,Sikandra,189,265174,142746,122428
09,164,00000,DISTRICT,Kanpur Nagar,902,1565623,837260,728363
09,164,00848,SUB-DISTRICT,Bilhaur ,352,486799,260655,226144
09,164,00849,SUB-DISTRICT,Kanpur ,252,538538,286866,251672
09,164,00850,SUB-DISTRICT,Ghatampur ,298,540286,289739,250547
09,165,00000,DISTRICT,Jalaun ,942,1271074,683656,587418
09,165,00851,SUB-DISTRICT,Madhogarh,223,303270,163520,139750
09,165,00852,SUB-DISTRICT,Jalaun,183,226878,121751,105127
09,165,00853,SUB-DISTRICT,Kalpi ,195,303287,164004,139283
09,165,00854,SUB-DISTRICT,Orai,128,197817,106381,91436
09,165,00855,SUB-DISTRICT,Konch,213,239822,128000,111822
09,166,00000,DISTRICT,Jhansi,745,1165119,615629,549490
09,166,00856,SUB-DISTRICT,Moth,188,255881,134796,121085
09,166,00857,SUB-DISTRICT,Garautha,137,186481,100087,86394
09,166,00858,SUB-DISTRICT,Tahrauli,134,165899,87310,78589
09,166,00859,SUB-DISTRICT,Mauranipur,147,301080,158287,142793
09,166,00860,SUB-DISTRICT,Jhansi,139,255778,135149,120629
09,167,00000,DISTRICT,Lalitpur,691,1046214,549478,496736
09,167,00861,SUB-DISTRICT,Talbehat,162,291968,155110,136858
09,167,00862,SUB-DISTRICT,Lalitpur ,263,360615,188598,172017
09,167,00863,SUB-DISTRICT,Mahroni,266,393631,205770,187861
09,168,00000,DISTRICT,Hamirpur,497,894437,481373,413064
09,168,00864,SUB-DISTRICT,Hamirpur,147,276449,148807,127642
09,168,00865,SUB-DISTRICT,Rath,103,153925,82176,71749
09,168,00866,SUB-DISTRICT,Sarila,98,152903,82519,70384
09,168,00867,SUB-DISTRICT,Maudaha,149,311160,167871,143289
09,169,00000,DISTRICT,Mahoba,435,690577,368009,322568
09,169,00868,SUB-DISTRICT,Kulpahar,227,316872,168477,148395
09,169,00869,SUB-DISTRICT,Charkhari,83,113902,60851,53051
09,169,00870,SUB-DISTRICT,Mahoba ,125,259803,138681,121122
09,170,00000,DISTRICT,Banda,657,1523655,819243,704412
09,170,00871,SUB-DISTRICT,Banda,198,483107,260762,222345
09,170,00872,SUB-DISTRICT,Baberu,182,463869,249223,214646
09,170,00873,SUB-DISTRICT,Atarra ,102,294596,157921,136675
09,170,00874,SUB-DISTRICT,Naraini,175,282083,151337,130746
09,171,00000,DISTRICT,Chitrakoot,562,895398,476794,418604
09,171,00875,SUB-DISTRICT,Karwi,387,627079,334804,292275
09,171,00876,SUB-DISTRICT,Mau,175,268319,141990,126329
09,172,00000,DISTRICT,Fatehpur,1352,2310740,1215690,1095050
09,172,00877,SUB-DISTRICT,Bindki,395,686360,361874,324486
09,172,00878,SUB-DISTRICT,Fatehpur,476,892229,470613,421616
09,172,00879,SUB-DISTRICT,Khaga ,481,732151,383203,348948
09,173,00000,DISTRICT,Pratapgarh,2183,3033899,1515583,1518316
09,173,00880,SUB-DISTRICT,Lalganj ,442,610526,303372,307154
09,173,00881,SUB-DISTRICT,Kunda,484,867833,436560,431273
09,173,00882,SUB-DISTRICT,Pratapgarh,406,518368,261142,257226
09,173,00883,SUB-DISTRICT,Patti,549,599760,295940,303820
09,173,00884,SUB-DISTRICT,Raniganj,302,437412,218569,218843
09,174,00000,DISTRICT,Kaushambi,729,1475140,773335,701805
09,174,00885,SUB-DISTRICT,Sirathu,244,483614,251998,231616
09,174,00886,SUB-DISTRICT,Manjhanpur ,267,530491,277723,252768
09,174,00887,SUB-DISTRICT,Chail,218,461035,243614,217421
09,175,00000,DISTRICT,Allahabad ,2809,4481518,2340959,2140559
09,175,00888,SUB-DISTRICT,Soraon,404,764633,396908,367725
09,175,00889,SUB-DISTRICT,Phulpur ,503,793301,411980,381321
09,175,00890,SUB-DISTRICT,Allahabad,85,181396,103209,78187
09,175,00891,SUB-DISTRICT,Bara  ,294,335212,176643,158569
09,175,00892,SUB-DISTRICT,Karchhana ,303,569191,298125,271066
09,175,00893,SUB-DISTRICT,Handia,609,922919,476113,446806
09,175,00894,SUB-DISTRICT,Meja,347,550848,287239,263609
09,175,00895,SUB-DISTRICT,Koraon,264,364018,190742,173276
09,176,00000,DISTRICT,Bara Banki,1817,2929896,1533455,1396441
09,176,00896,SUB-DISTRICT,Fatehpur,400,554075,291007,263068
09,176,00897,SUB-DISTRICT,Ramnagar ,235,290546,155253,135293
09,176,00898,SUB-DISTRICT,Nawabganj ,387,768336,400432,367904
09,176,00899,SUB-DISTRICT,Sirauli Gauspur,181,311996,162798,149198
09,176,00900,SUB-DISTRICT,Ramsanehighat,244,426879,223488,203391
09,176,00901,SUB-DISTRICT,Haidergarh,370,578064,300477,277587
09,177,00000,DISTRICT,Faizabad,1235,2130743,1079257,1051486
09,177,00902,SUB-DISTRICT,Rudauli,239,421159,215746,205413
09,177,00903,SUB-DISTRICT,Milkipur,280,479707,241672,238035
09,177,00904,SUB-DISTRICT,Sohawal,148,372664,189925,182739
09,177,00905,SUB-DISTRICT,Faizabad,229,421902,214826,207076
09,177,00906,SUB-DISTRICT,Bikapur,339,435311,217088,218223
09,178,00000,DISTRICT,Ambedkar Nagar,1649,2117158,1067762,1049396
09,178,00907,SUB-DISTRICT,Tanda,366,473161,241951,231210
09,178,00908,SUB-DISTRICT,Allapur,423,440496,219757,220739
09,178,00909,SUB-DISTRICT,Jalalpur ,308,508647,256806,251841
09,178,00910,SUB-DISTRICT,Akbarpur,301,446185,224432,221753
09,178,00911,SUB-DISTRICT,Bhiti,251,248669,124816,123853
09,179,00000,DISTRICT,Sultanpur,2498,3597201,1810496,1786705
09,179,00912,SUB-DISTRICT,Musafirkhana ,341,677165,342542,334623
09,179,00913,SUB-DISTRICT,Gauriganj,257,390935,196844,194091
09,179,00914,SUB-DISTRICT,Amethi ,290,426957,213165,213792
09,179,00915,SUB-DISTRICT,Sultanpur,427,717411,363777,353634
09,179,00916,SUB-DISTRICT,Jaisinghpur,384,420611,211201,209410
09,179,00917,SUB-DISTRICT,Lambhua,448,462637,230176,232461
09,179,00918,SUB-DISTRICT,Kadipur ,351,501485,252791,248694
09,180,00000,DISTRICT,Bahraich,1359,3203687,1695122,1508565
09,180,00919,SUB-DISTRICT,Nanpara ,410,1207263,638132,569131
09,180,00920,SUB-DISTRICT,Mahasi,225,546995,290355,256640
09,180,00921,SUB-DISTRICT,Bahraich,292,643932,341030,302902
09,180,00922,SUB-DISTRICT,Kaiserganj,432,805497,425605,379892
09,181,00000,DISTRICT,Shrawasti,509,1078712,573681,505031
09,181,00923,SUB-DISTRICT,Bhinga,283,657685,350403,307282
09,181,00924,SUB-DISTRICT,Ikauna,226,421027,223278,197749
09,182,00000,DISTRICT,Balrampur,998,1982274,1027943,954331
09,182,00925,SUB-DISTRICT,Balrampur,263,579854,308288,271566
09,182,00926,SUB-DISTRICT,Tulsipur,376,731723,382431,349292
09,182,00927,SUB-DISTRICT,Utraula,359,670697,337224,333473
09,183,00000,DISTRICT,Gonda,1812,3208890,1669058,1539832
09,183,00928,SUB-DISTRICT,Gonda ,589,1016258,531949,484309
09,183,00929,SUB-DISTRICT,Colonelganj ,387,818093,428912,389181
09,183,00930,SUB-DISTRICT,Tarabganj,359,744508,384625,359883
09,183,00931,SUB-DISTRICT,Mankapur ,477,630031,323572,306459
09,184,00000,DISTRICT,Siddharthnagar,2336,2398606,1212141,1186465
09,184,00932,SUB-DISTRICT,Shohratgarh,351,396714,201476,195238
09,184,00933,SUB-DISTRICT,Naugarh,453,560575,287566,273009
09,184,00934,SUB-DISTRICT,Bansi,707,557165,280320,276845
09,184,00935,SUB-DISTRICT,Itwa,433,445987,221399,224588
09,184,00936,SUB-DISTRICT,Domariyaganj,392,438165,221380,216785
09,185,00000,DISTRICT,Basti,3160,2326367,1182846,1143521
09,185,00937,SUB-DISTRICT,Bhanpur,419,358572,179997,178575
09,185,00938,SUB-DISTRICT,Harraiya,1457,926961,471196,455765
09,185,00939,SUB-DISTRICT,Basti,1027,834804,428713,406091
09,185,00940,SUB-DISTRICT,Rudhauli,257,206030,102940,103090
09,186,00000,DISTRICT,Sant Kabir Nagar,1582,1586652,802609,784043
09,186,00941,SUB-DISTRICT,Mehdawal,454,447332,225655,221677
09,186,00942,SUB-DISTRICT,Khalilabad,594,632983,320281,312702
09,186,00943,SUB-DISTRICT,Ghanghata,534,506337,256673,249664
09,187,00000,DISTRICT,Mahrajganj,1212,2549973,1312126,1237847
09,187,00944,SUB-DISTRICT,Nautanwa,263,471006,243472,227534
09,187,00945,SUB-DISTRICT,Nichlaul,282,500384,257089,243295
09,187,00946,SUB-DISTRICT,Pharenda,225,477123,247284,229839
09,187,00947,SUB-DISTRICT,Maharajganj,442,1101460,564281,537179
09,188,00000,DISTRICT,Gorakhpur,2937,3604766,1838726,1766040
09,188,00948,SUB-DISTRICT,Campierganj,202,381626,197439,184187
09,188,00949,SUB-DISTRICT,Sahjanwa,302,354651,182456,172195
09,188,00950,SUB-DISTRICT,Gorakhpur,440,906721,468602,438119
09,188,00951,SUB-DISTRICT,Chauri Chaura,205,442596,224553,218043
09,188,00952,SUB-DISTRICT,Bansgaon,468,431859,216626,215233
09,188,00953,SUB-DISTRICT,Khajni,694,583987,296820,287167
09,188,00954,SUB-DISTRICT,Gola ,626,503326,252230,251096
09,189,00000,DISTRICT,Kushinagar,1579,3396437,1730377,1666060
09,189,00955,SUB-DISTRICT,Padrauna,519,1060699,545755,514944
09,189,00956,SUB-DISTRICT,Hata,402,905552,457438,448114
09,189,00957,SUB-DISTRICT,Kasya,286,585713,296432,289281
09,189,00958,SUB-DISTRICT,Tamkuhi Raj,372,844473,430752,413721
09,190,00000,DISTRICT,Deoria,2019,2784143,1373111,1411032
09,190,00959,SUB-DISTRICT,Deoria,686,1091560,541510,550050
09,190,00960,SUB-DISTRICT,Rudrapur,274,405749,201074,204675
09,190,00961,SUB-DISTRICT,Barhaj,265,333535,163278,170257
09,190,00962,SUB-DISTRICT,Salempur,471,518882,254331,264551
09,190,00963,SUB-DISTRICT,Bhatpar Rani,323,434417,212918,221499
09,191,00000,DISTRICT,Azamgarh,3800,4220512,2082707,2137805
09,191,00964,SUB-DISTRICT,Burhanpur,466,449694,220894,228800
09,191,00965,SUB-DISTRICT,Sagri,882,857676,426359,431317
09,191,00966,SUB-DISTRICT,Azamgarh ,605,715365,361197,354168
09,191,00967,SUB-DISTRICT,Nizamabad,536,562812,276309,286503
09,191,00968,SUB-DISTRICT,Phulpur ,498,680948,333746,347202
09,191,00969,SUB-DISTRICT,Lalganj,517,568180,274251,293929
09,191,00970,SUB-DISTRICT,Mehnagar,296,385837,189951,195886
09,192,00000,DISTRICT,Mau,1499,1706760,858843,847917
09,192,00971,SUB-DISTRICT,Ghosi,328,411215,203756,207459
09,192,00972,SUB-DISTRICT,Madhuban,322,329279,163523,165756
09,192,00973,SUB-DISTRICT,Maunath Bhanjan,404,558316,286220,272096
09,192,00974,SUB-DISTRICT,Muhammadabad Gohna,445,407950,205344,202606
09,193,00000,DISTRICT,Ballia,1843,2935665,1514018,1421647
09,193,00975,SUB-DISTRICT,Belthara Road,268,371890,189454,182436
09,193,00976,SUB-DISTRICT,Sikanderpur,217,368815,187889,180926
09,193,00977,SUB-DISTRICT,Rasra,346,516245,263863,252382
09,193,00978,SUB-DISTRICT,Ballia,527,839511,438639,400872
09,193,00979,SUB-DISTRICT,Bansdih,377,452459,232856,219603
09,193,00980,SUB-DISTRICT,Bairia,108,386745,201317,185428
09,194,00000,DISTRICT,Jaunpur,3287,4147624,2041217,2106407
09,194,00981,SUB-DISTRICT,Shahganj,518,716000,358112,357888
09,194,00982,SUB-DISTRICT,Badlapur,405,456043,224905,231138
09,194,00983,SUB-DISTRICT,Machhlishahr,504,690098,337373,352725
09,194,00984,SUB-DISTRICT,Jaunpur ,787,868864,432825,436039
09,194,00985,SUB-DISTRICT,Mariahu ,652,771872,373763,398109
09,194,00986,SUB-DISTRICT,Kerakat,421,644747,314239,330508
09,195,00000,DISTRICT,Ghazipur,2740,3345908,1711651,1634257
09,195,00987,SUB-DISTRICT,Jakhania,505,535437,268385,267052
09,195,00988,SUB-DISTRICT,Saidpur,582,579132,289895,289237
09,195,00989,SUB-DISTRICT,Ghazipur,539,706640,366174,340466
09,195,00990,SUB-DISTRICT,Mohammadabad ,833,856497,440295,416202
09,195,00991,SUB-DISTRICT,Zamania,281,668202,346902,321300
09,196,00000,DISTRICT,Chandauli,1425,1710203,890630,819573
09,196,00992,SUB-DISTRICT,Sakaldiha,456,683952,354200,329752
09,196,00993,SUB-DISTRICT,Chandauli,438,616921,322888,294033
09,196,00994,SUB-DISTRICT,Chakia,531,409330,213542,195788
09,197,00000,DISTRICT,Varanasi,1258,2079790,1076526,1003264
09,197,00995,SUB-DISTRICT,Pindra,423,615915,312099,303816
09,197,00996,SUB-DISTRICT,Varanasi,835,1463875,764427,699448
09,198,00000,DISTRICT,Sant Ravidas Nagar (Bhadohi),1087,1348911,686589,662322
09,198,00997,SUB-DISTRICT,Bhadohi,382,435345,218566,216779
09,198,00998,SUB-DISTRICT,Gyanpur,385,524069,267338,256731
09,198,00999,SUB-DISTRICT,Aurai,320,389497,200685,188812
09,199,00000,DISTRICT,Mirzapur,1745,2149403,1127138,1022265
09,199,01000,SUB-DISTRICT,Mirzapur,611,897280,472862,424418
09,199,01001,SUB-DISTRICT,Lalganj,387,367080,192739,174341
09,199,01002,SUB-DISTRICT,Marihan,211,241128,125523,115605
09,199,01003,SUB-DISTRICT,Chunar,536,643915,336014,307901
09,200,00000,DISTRICT,Sonbhadra,1391,1548217,803345,744872
09,200,01004,SUB-DISTRICT,Ghorawal,342,283255,146964,136291
09,200,01005,SUB-DISTRICT,Robertsganj,770,776300,403074,373226
09,200,01006,SUB-DISTRICT,Dudhi,279,488662,253307,235355
09,201,00000,DISTRICT,Etah,853,1506338,805589,700749
09,201,01007,SUB-DISTRICT,Aliganj ,232,433338,232603,200735
09,201,01008,SUB-DISTRICT,Etah,471,770556,410994,359562
09,201,01009,SUB-DISTRICT,Jalesar ,150,302444,161992,140452
09,202,00000,DISTRICT,Kanshiram Nagar,650,1148512,612556,535956
09,202,01010,SUB-DISTRICT,Kasganj,224,417870,222591,195279
09,202,01011,SUB-DISTRICT,Sahawar,168,282458,150085,132373
09,202,01012,SUB-DISTRICT,Patiyali,258,448184,239880,208304
10,000,00000,STATE,BIHAR,39073,92341436,48073850,44267586
10,203,00000,DISTRICT,Pashchim Champaran,1365,3541877,1853809,1688068
10,203,01013,SUB-DISTRICT,Sidhaw,159,309874,160227,149647
10,203,01014,SUB-DISTRICT,Ramnagar,125,200691,104019,96672
10,203,01015,SUB-DISTRICT,Gaunaha,156,208169,108318,99851
10,203,01016,SUB-DISTRICT,Mainatanr,93,190744,99593,91151
10,203,01017,SUB-DISTRICT,Narkatiaganj,148,328335,171258,157077
10,203,01018,SUB-DISTRICT,Lauriya,93,230162,120402,109760
10,203,01019,SUB-DISTRICT,Bagaha,121,285366,149841,135525
10,203,01020,SUB-DISTRICT,Piprasi,3,38592,20321,18271
10,203,01021,SUB-DISTRICT,Madhubani,21,89608,46879,42729
10,203,01022,SUB-DISTRICT,Bhitaha,21,66203,34659,31544
10,203,01023,SUB-DISTRICT,Thakrahan,10,52766,27783,24983
10,203,01024,SUB-DISTRICT,Jogapatti,102,243516,128193,115323
10,203,01025,SUB-DISTRICT,Chanpatia,71,270653,142113,128540
10,203,01026,SUB-DISTRICT,Sikta,60,189496,99815,89681
10,203,01027,SUB-DISTRICT,Majhaulia,75,329347,172296,157051
10,203,01028,SUB-DISTRICT,Bettiah,14,75545,39588,35957
10,203,01029,SUB-DISTRICT,Bairia,51,199235,105473,93762
10,203,01030,SUB-DISTRICT,Nautan,42,233575,123031,110544
10,204,00000,DISTRICT,Purba Champaran,1252,4698028,2468181,2229847
10,204,01031,SUB-DISTRICT,Raxaul,41,176492,92921,83571
10,204,01032,SUB-DISTRICT,Adapur,60,203513,107913,95600
10,204,01033,SUB-DISTRICT,Ramgarhwa,43,200998,106637,94361
10,204,01034,SUB-DISTRICT,Sugauli,46,191992,101093,90899
10,204,01035,SUB-DISTRICT,Banjaria,30,162684,86088,76596
10,204,01036,SUB-DISTRICT,Narkatia,51,170758,89659,81099
10,204,01037,SUB-DISTRICT,Bankatwa,20,116863,60983,55880
10,204,01038,SUB-DISTRICT,Ghorasahan,26,174864,92262,82602
10,204,01039,SUB-DISTRICT,Dhaka,61,276081,144833,131248
10,204,01040,SUB-DISTRICT,Chiraia,41,276809,146459,130350
10,204,01041,SUB-DISTRICT,Motihari,68,237818,126392,111426
10,204,01042,SUB-DISTRICT,Turkaulia,33,180366,94136,86230
10,204,01043,SUB-DISTRICT,Harsidhi,61,222551,116865,105686
10,204,01044,SUB-DISTRICT,Paharpur,55,183018,95945,87073
10,204,01045,SUB-DISTRICT,Areraj,42,137909,73041,64868
10,204,01046,SUB-DISTRICT,Sangrampur,23,144071,74950,69121
10,204,01047,SUB-DISTRICT,Kesaria,41,175595,92003,83592
10,204,01048,SUB-DISTRICT,Kalyanpur,97,267568,137739,129829
10,204,01049,SUB-DISTRICT,Kotwa,44,168788,89046,79742
10,204,01050,SUB-DISTRICT,Piprakothi,20,77089,40837,36252
10,204,01051,SUB-DISTRICT,Chakia(Pipra),76,195590,101014,94576
10,204,01052,SUB-DISTRICT,Pakri Dayal,20,116634,60240,56394
10,204,01053,SUB-DISTRICT,Patahi,37,166445,87494,78951
10,204,01054,SUB-DISTRICT,Phenhara,26,80329,42706,37623
10,204,01055,SUB-DISTRICT,Madhuban,54,143250,75400,67850
10,204,01056,SUB-DISTRICT,Tetaria,46,102808,54212,48596
10,204,01057,SUB-DISTRICT,Mehsi,90,147145,77313,69832
10,205,00000,DISTRICT,Sheohar,191,628130,331792,296338
10,205,01058,SUB-DISTRICT,Purnahiya,26,91949,48630,43319
10,205,01059,SUB-DISTRICT,Piprarhi,23,117948,61680,56268
10,205,01060,SUB-DISTRICT,Sheohar,43,127142,67228,59914
10,205,01061,SUB-DISTRICT,Dumri Katsari,27,93398,49454,43944
10,205,01062,SUB-DISTRICT,Tariani Chowk,72,197693,104800,92893
10,206,00000,DISTRICT,Sitamarhi,808,3233076,1701685,1531391
10,206,01063,SUB-DISTRICT,Bairgania,19,89259,47115,42144
10,206,01064,SUB-DISTRICT,Suppi,36,122239,64616,57623
10,206,01065,SUB-DISTRICT,Majorganj,27,102785,54031,48754
10,206,01066,SUB-DISTRICT,Sonbarsa,61,251248,131668,119580
10,206,01067,SUB-DISTRICT,Parihar,83,338222,177463,160759
10,206,01068,SUB-DISTRICT,Sursand,52,209945,109991,99954
10,206,01069,SUB-DISTRICT,Bathnaha,87,262527,138384,124143
10,206,01070,SUB-DISTRICT,Riga,39,206979,109257,97722
10,206,01071,SUB-DISTRICT,Parsauni,22,86016,45441,40575
10,206,01072,SUB-DISTRICT,Belsand,38,100340,52973,47367
10,206,01073,SUB-DISTRICT,Runisaidpur,100,372579,197632,174947
10,206,01074,SUB-DISTRICT,Dumra,73,326332,173053,153279
10,206,01075,SUB-DISTRICT,Bajpatti,56,215507,113078,102429
10,206,01076,SUB-DISTRICT,Charaut,17,79310,41740,37570
10,206,01077,SUB-DISTRICT,Pupri,44,156473,81631,74842
10,206,01078,SUB-DISTRICT,Nanpur,31,182429,94901,87528
10,206,01079,SUB-DISTRICT,Bokhara,23,130886,68711,62175
10,207,00000,DISTRICT,Madhubani,1040,4325884,2244287,2081597
10,207,01080,SUB-DISTRICT,Madhwapur,41,134704,68909,65795
10,207,01081,SUB-DISTRICT,Harlakhi,43,196251,101522,94729
10,207,01082,SUB-DISTRICT,Basopatti,33,173499,90774,82725
10,207,01083,SUB-DISTRICT,Jainagar,21,171918,90713,81205
10,207,01084,SUB-DISTRICT,Ladania,28,175561,90896,84665
10,207,01085,SUB-DISTRICT,Laukaha,44,212127,108413,103714
10,207,01086,SUB-DISTRICT,Laukahi,64,208317,107031,101286
10,207,01087,SUB-DISTRICT,Phulparas,40,166018,86249,79769
10,207,01088,SUB-DISTRICT,Babubarhi,61,217331,111970,105361
10,207,01089,SUB-DISTRICT,Khajauli,32,143583,75209,68374
10,207,01090,SUB-DISTRICT,Kaluahi,18,117282,60713,56569
10,207,01091,SUB-DISTRICT,Benipatti,96,361400,188764,172636
10,207,01092,SUB-DISTRICT,Bisfi,52,320704,167767,152937
10,207,01093,SUB-DISTRICT,Madhubani,69,240786,125446,115340
10,207,01094,SUB-DISTRICT,Pandaul,63,270642,140092,130550
10,207,01095,SUB-DISTRICT,Rajnagar,62,238873,123675,115198
10,207,01096,SUB-DISTRICT,Andhratharhi,46,191680,100056,91624
10,207,01097,SUB-DISTRICT,Jhanjharpur,58,174930,90255,84675
10,207,01098,SUB-DISTRICT,Ghoghardiha,48,174831,89555,85276
10,207,01099,SUB-DISTRICT,Lakhnaur,38,167841,86959,80882
10,207,01100,SUB-DISTRICT,Madhepur,83,267606,139319,128287
10,208,00000,DISTRICT,Supaul,526,2123518,1099495,1024023
10,208,01101,SUB-DISTRICT,Nirmali,21,78246,40148,38098
10,208,01102,SUB-DISTRICT,Basantpur,87,182075,94277,87798
10,208,01103,SUB-DISTRICT,Chhatapur,62,286456,148676,137780
10,208,01104,SUB-DISTRICT,Pratapganj,12,106884,55458,51426
10,208,01105,SUB-DISTRICT,Raghopur,58,215643,111153,104490
10,208,01106,SUB-DISTRICT,Saraigarh Bhaptiyahi,39,122772,63268,59504
10,208,01107,SUB-DISTRICT,Kishanpur,44,167669,86714,80955
10,208,01108,SUB-DISTRICT,Marauna,37,145136,74701,70435
10,208,01109,SUB-DISTRICT,Supaul,72,294761,153392,141369
10,208,01110,SUB-DISTRICT,Pipra,38,201399,104247,97152
10,208,01111,SUB-DISTRICT,Tribeniganj,56,322477,167461,155016
10,209,00000,DISTRICT,Araria,716,2642792,1374254,1268538
10,209,01112,SUB-DISTRICT,Narpatganj,64,351773,183366,168407
10,209,01113,SUB-DISTRICT,Forbesganj,105,396364,206539,189825
10,209,01114,SUB-DISTRICT,Bhargama,55,230835,120475,110360
10,209,01115,SUB-DISTRICT,Raniganj,87,398977,207079,191898
10,209,01116,SUB-DISTRICT,Araria,81,386508,200411,186097
10,209,01117,SUB-DISTRICT,Kursakatta,68,149231,78008,71223
10,209,01118,SUB-DISTRICT,Sikti,54,158543,81644,76899
10,209,01119,SUB-DISTRICT,Palasi,104,248369,128843,119526
10,209,01120,SUB-DISTRICT,Jokihat,98,322192,167889,154303
10,210,00000,DISTRICT,Kishanganj,732,1529277,783318,745959
10,210,01121,SUB-DISTRICT,Terhagachh,78,141039,72740,68299
10,210,01122,SUB-DISTRICT,Dighalbank,80,208356,106454,101902
10,210,01123,SUB-DISTRICT,Thakurganj,119,273323,140547,132776
10,210,01124,SUB-DISTRICT,Pothia,141,262494,135774,126720
10,210,01125,SUB-DISTRICT,Bahadurganj,103,216589,106895,109694
10,210,01126,SUB-DISTRICT,Kochadhamin,143,292124,151357,140767
10,210,01127,SUB-DISTRICT,Kishanganj,68,135352,69551,65801
10,211,00000,DISTRICT,Purnia,1113,2921614,1519522,1402092
10,211,01128,SUB-DISTRICT,Banmankhi,81,321079,167938,153141
10,211,01129,SUB-DISTRICT,Barhara,53,209000,109302,99698
10,211,01130,SUB-DISTRICT,Bhawanipur,66,161720,84098,77622
10,211,01131,SUB-DISTRICT,Rupauli,44,234686,122633,112053
10,211,01132,SUB-DISTRICT,Dhamdaha,72,288084,150332,137752
10,211,01133,SUB-DISTRICT,Krityanand Nagar,68,230504,119494,111010
10,211,01134,SUB-DISTRICT,Purnia East,77,163078,84356,78722
10,211,01135,SUB-DISTRICT,Kasba,59,157920,81518,76402
10,211,01136,SUB-DISTRICT,Srinagar,27,110058,57071,52987
10,211,01137,SUB-DISTRICT,Jalalgarh,46,112951,58460,54491
10,211,01138,SUB-DISTRICT,Amour,150,290559,151531,139028
10,211,01139,SUB-DISTRICT,Baisa,118,193127,100187,92940
10,211,01140,SUB-DISTRICT,Baisi,112,227706,117648,110058
10,211,01141,SUB-DISTRICT,Dagarua,140,221142,114954,106188
10,212,00000,DISTRICT,Katihar,1306,2797207,1455744,1341463
10,212,01142,SUB-DISTRICT,Falka,59,155663,80642,75021
10,212,01143,SUB-DISTRICT,Korha,72,282813,146408,136405
10,212,01144,SUB-DISTRICT,Hasanganj,39,55906,28994,26912
10,212,01145,SUB-DISTRICT,Kadwa,234,346902,180485,166417
10,212,01146,SUB-DISTRICT,Balrampur,130,158976,82192,76784
10,212,01147,SUB-DISTRICT,Barsoi,218,337778,175971,161807
10,212,01148,SUB-DISTRICT,Azamnagar,214,315610,164364,151246
10,212,01149,SUB-DISTRICT,Pranpur,76,144297,74979,69318
10,212,01150,SUB-DISTRICT,Dandkhora,47,68055,35321,32734
10,212,01151,SUB-DISTRICT,Katihar,26,80979,42093,38886
10,212,01152,SUB-DISTRICT,Mansahi,26,84257,43777,40480
10,212,01153,SUB-DISTRICT,Barari,48,285381,149773,135608
10,212,01154,SUB-DISTRICT,Sameli,23,84486,44038,40448
10,212,01155,SUB-DISTRICT,Kursela,10,63928,33568,30360
10,212,01156,SUB-DISTRICT,Manihari,42,164778,86319,78459
10,212,01157,SUB-DISTRICT,Amdabad,42,167398,86820,80578
10,213,00000,DISTRICT,Madhepura,380,1913301,1000760,912541
10,213,01158,SUB-DISTRICT,Gamharia,12,82522,42950,39572
10,213,01159,SUB-DISTRICT,Singheshwar,26,128861,67483,61378
10,213,01160,SUB-DISTRICT,Ghailarh,15,91818,47805,44013
10,213,01161,SUB-DISTRICT,Madhepura,44,191375,100292,91083
10,213,01162,SUB-DISTRICT,Shankarpur,9,106222,55157,51065
10,213,01163,SUB-DISTRICT,Kumarkhand,58,243629,127577,116052
10,213,01164,SUB-DISTRICT,Murliganj,35,185631,97180,88451
10,213,01165,SUB-DISTRICT,Gwalpara,50,126020,65271,60749
10,213,01166,SUB-DISTRICT,Bihariganj,23,135534,70615,64919
10,213,01167,SUB-DISTRICT,Kishanganj,38,189159,99033,90126
10,213,01168,SUB-DISTRICT,Puraini,22,104436,54688,49748
10,213,01169,SUB-DISTRICT,Alamnagar,28,175401,92171,83230
10,213,01170,SUB-DISTRICT,Chausa,20,152693,80538,72155
10,214,00000,DISTRICT,Saharsa,445,1744121,913883,830238
10,214,01171,SUB-DISTRICT,Nauhatta,54,161784,84347,77437
10,214,01172,SUB-DISTRICT,Satar Kataiya,37,151060,79332,71728
10,214,01173,SUB-DISTRICT,Mahishi,73,206774,108437,98337
10,214,01174,SUB-DISTRICT,Kahara,37,141805,74224,67581
10,214,01175,SUB-DISTRICT,Saur Bazar,55,214166,111963,102203
10,214,01176,SUB-DISTRICT,Patarghat,15,128322,67197,61125
10,214,01177,SUB-DISTRICT,Sonbarsa,59,235841,123078,112763
10,214,01178,SUB-DISTRICT,Simri Bakhtiarpur,58,280582,147626,132956
10,214,01179,SUB-DISTRICT,Salkhua,39,132844,69953,62891
10,214,01180,SUB-DISTRICT,Banma Itahri,18,90943,47726,43217
10,215,00000,DISTRICT,Darbhanga,1069,3554057,1858545,1695512
10,215,01181,SUB-DISTRICT,Jale,58,264248,136448,127800
10,215,01182,SUB-DISTRICT,Singhwara,87,267601,138285,129316
10,215,01183,SUB-DISTRICT,Keotiranway,96,270722,142147,128575
10,215,01184,SUB-DISTRICT,Darbhanga,106,273431,144391,129040
10,215,01185,SUB-DISTRICT,Manigachhi,42,228618,118772,109846
10,215,01186,SUB-DISTRICT,Tardih,38,123299,64000,59299
10,215,01187,SUB-DISTRICT,Alinagar,39,143797,74574,69223
10,215,01188,SUB-DISTRICT,Benipur,39,175040,91241,83799
10,215,01189,SUB-DISTRICT,Bahadurpur,126,257399,136138,121261
10,215,01190,SUB-DISTRICT,Hanumannagar,65,154631,82107,72524
10,215,01191,SUB-DISTRICT,Hayaghat,43,148081,78245,69836
10,215,01192,SUB-DISTRICT,Baheri,72,302645,159342,143303
10,215,01193,SUB-DISTRICT,Biraul,62,286113,149326,136787
10,215,01194,SUB-DISTRICT,Ghanshyampur,27,133210,69394,63816
10,215,01195,SUB-DISTRICT,Kiratpur,17,81423,42458,38965
10,215,01196,SUB-DISTRICT,Gora Bauram,46,152112,78823,73289
10,215,01197,SUB-DISTRICT,Kusheshwar Asthan,71,162870,84977,77893
10,215,01198,SUB-DISTRICT,Kusheshwar Asthan Purbi,35,128817,67877,60940
10,216,00000,DISTRICT,Muzaffarpur,1719,4327625,2276812,2050813
10,216,01199,SUB-DISTRICT,Sahebganj,121,218214,114143,104071
10,216,01200,SUB-DISTRICT,Baruraj (Motipur),129,378223,199118,179105
10,216,01201,SUB-DISTRICT,Paroo,136,361662,190216,171446
10,216,01202,SUB-DISTRICT,Saraiya,150,331651,174162,157489
10,216,01203,SUB-DISTRICT,Marwan,62,164858,86600,78258
10,216,01204,SUB-DISTRICT,Kanti,105,233923,123025,110898
10,216,01205,SUB-DISTRICT,Minapur,152,340925,180765,160160
10,216,01206,SUB-DISTRICT,Bochaha,125,245659,129445,116214
10,216,01207,SUB-DISTRICT,Aurai,107,290545,153987,136558
10,216,01208,SUB-DISTRICT,Katra,76,244823,128296,116527
10,216,01209,SUB-DISTRICT,Gaighat,81,259719,136976,122743
10,216,01210,SUB-DISTRICT,Bandra,42,124057,63306,60751
10,216,01211,SUB-DISTRICT,Dholi (Moraul),36,90490,46967,43523
10,216,01212,SUB-DISTRICT,Musahri,111,300367,158081,142286
10,216,01213,SUB-DISTRICT,Kurhani,165,435676,230433,205243
10,216,01214,SUB-DISTRICT,Sakra,121,306833,161292,145541
10,217,00000,DISTRICT,Gopalganj,1395,2399207,1184967,1214240
10,217,01215,SUB-DISTRICT,Katiya,101,110637,52338,58299
10,217,01216,SUB-DISTRICT,Bijaipur,125,133038,63841,69197
10,217,01217,SUB-DISTRICT,Bhorey,154,178199,86326,91873
10,217,01218,SUB-DISTRICT,Pach Deuri,94,99933,48924,51009
10,217,01219,SUB-DISTRICT,Kuchaikote,216,332041,165651,166390
10,217,01220,SUB-DISTRICT,Phulwaria,99,130801,64952,65849
10,217,01221,SUB-DISTRICT,Hathua,103,214648,106875,107773
10,217,01222,SUB-DISTRICT,Uchkagaon,75,151437,74446,76991
10,217,01223,SUB-DISTRICT,Thawe,49,116106,59014,57092
10,217,01224,SUB-DISTRICT,Gopalganj,60,152188,76980,75208
10,217,01225,SUB-DISTRICT,Manjha,104,199452,97285,102167
10,217,01226,SUB-DISTRICT,Barauli,75,221999,109742,112257
10,217,01227,SUB-DISTRICT,Sidhwalia,48,141563,70633,70930
10,217,01228,SUB-DISTRICT,Baikunthpur,92,217165,107960,109205
10,218,00000,DISTRICT,Siwan,1435,3147551,1579685,1567866
10,218,01229,SUB-DISTRICT,Nautan,46,90714,45856,44858
10,218,01230,SUB-DISTRICT,Siwan,81,205917,105022,100895
10,218,01231,SUB-DISTRICT,Barharia,139,321292,164179,157113
10,218,01232,SUB-DISTRICT,Goriakothi,81,223709,111167,112542
10,218,01233,SUB-DISTRICT,Lakri Nabiganj,39,128899,63670,65229
10,218,01234,SUB-DISTRICT,Basantpur,41,105229,53733,51496
10,218,01235,SUB-DISTRICT,Bhagwanpur Hat,113,220651,111578,109073
10,218,01236,SUB-DISTRICT,Maharajganj,69,165935,81731,84204
10,218,01237,SUB-DISTRICT,Pachrukhi,81,201759,101688,100071
10,218,01238,SUB-DISTRICT,Hussainganj,45,182794,93003,89791
10,218,01239,SUB-DISTRICT,Ziradei,79,163752,81467,82285
10,218,01240,SUB-DISTRICT,Mairwa,52,89934,45747,44187
10,218,01241,SUB-DISTRICT,Guthani,98,128155,64275,63880
10,218,01242,SUB-DISTRICT,Darauli,98,174357,87634,86723
10,218,01243,SUB-DISTRICT,Andar,61,110027,54471,55556
10,218,01244,SUB-DISTRICT,Raghunathpur,99,157694,78000,79694
10,218,01245,SUB-DISTRICT,Hasanpura,60,149580,73069,76511
10,218,01246,SUB-DISTRICT,Daraundha,79,173200,85712,87488
10,218,01247,SUB-DISTRICT,Siswan,74,153953,77683,76270
10,219,00000,DISTRICT,Saran,1570,3598660,1838119,1760541
10,219,01248,SUB-DISTRICT,Mashrakh,67,188899,95509,93390
10,219,01249,SUB-DISTRICT,Panapur,62,121738,61317,60421
10,219,01250,SUB-DISTRICT,Taraiya,72,138721,70235,68486
10,219,01251,SUB-DISTRICT,Ishupur,61,146822,73894,72928
10,219,01252,SUB-DISTRICT,Baniapur,108,262673,132071,130602
10,219,01253,SUB-DISTRICT,Lahladpur,36,79969,38558,41411
10,219,01254,SUB-DISTRICT,Ekma,92,214445,107972,106473
10,219,01255,SUB-DISTRICT,Manjhi,110,268073,136520,131553
10,219,01256,SUB-DISTRICT,Jalalpur,65,174156,88658,85498
10,219,01257,SUB-DISTRICT,Revelganj,41,80621,41968,38653
10,219,01258,SUB-DISTRICT,Chapra,92,228925,120698,108227
10,219,01259,SUB-DISTRICT,Nagra,59,124028,64086,59942
10,219,01260,SUB-DISTRICT,Marhaura,105,235191,119970,115221
10,219,01261,SUB-DISTRICT,Amnour,118,200395,101804,98591
10,219,01262,SUB-DISTRICT,Maker,39,84695,41623,43072
10,219,01263,SUB-DISTRICT,Parsa,85,155838,80884,74954
10,219,01264,SUB-DISTRICT,Dariapur,152,296164,152224,143940
10,219,01265,SUB-DISTRICT,Garkha,99,268156,136799,131357
10,219,01266,SUB-DISTRICT,Dighwara,34,96811,50404,46407
10,219,01267,SUB-DISTRICT,Sonepur,73,232340,122925,109415
10,220,00000,DISTRICT,Vaishali,1422,3261942,1721221,1540721
10,220,01268,SUB-DISTRICT,Vaishali,114,187486,98441,89045
10,220,01269,SUB-DISTRICT,Paterhi Belsar,48,95669,49947,45722
10,220,01270,SUB-DISTRICT,Lalganj,92,228286,121388,106898
10,220,01271,SUB-DISTRICT,Bhagwanpur,99,207762,109864,97898
10,220,01272,SUB-DISTRICT,Goraul,86,177586,93127,84459
10,220,01273,SUB-DISTRICT,Chehra Kalan,49,131004,68517,62487
10,220,01274,SUB-DISTRICT,Patepur,138,370182,192661,177521
10,220,01275,SUB-DISTRICT,Mahua,128,284526,150128,134398
10,220,01276,SUB-DISTRICT,Jandaha,118,276217,146352,129865
10,220,01277,SUB-DISTRICT,Raja Pakar,68,158130,83583,74547
10,220,01278,SUB-DISTRICT,Hajipur,178,296288,157378,138910
10,220,01279,SUB-DISTRICT,Raghopur,53,232909,125023,107886
10,220,01280,SUB-DISTRICT,Bidupur,116,268849,143090,125759
10,220,01281,SUB-DISTRICT,Desri,37,87606,46046,41560
10,220,01282,SUB-DISTRICT,Sahdai Buzurg,49,127396,66987,60409
10,220,01283,SUB-DISTRICT,Mahnar,49,132046,68689,63357
10,221,00000,DISTRICT,Samastipur,1129,4113769,2152273,1961496
10,221,01284,SUB-DISTRICT,Kalyanpur,130,305116,157634,147482
10,221,01285,SUB-DISTRICT,Warisnagar,68,208496,109584,98912
10,221,01286,SUB-DISTRICT,Shivaji Nagar,68,193850,101771,92079
10,221,01287,SUB-DISTRICT,Khanpur,55,195729,102037,93692
10,221,01288,SUB-DISTRICT,Samastipur,88,266279,140727,125552
10,221,01289,SUB-DISTRICT,Pusa,37,132932,69662,63270
10,221,01290,SUB-DISTRICT,Tajpur,61,161626,85179,76447
10,221,01291,SUB-DISTRICT,Morwa,60,186075,97011,89064
10,221,01292,SUB-DISTRICT,Patori,49,179956,94760,85196
10,221,01293,SUB-DISTRICT,Mohanpur,19,115032,61140,53892
10,221,01294,SUB-DISTRICT,Mohiuddinagar,44,184521,97241,87280
10,221,01295,SUB-DISTRICT,Sarairanjan,55,254835,132000,122835
10,221,01296,SUB-DISTRICT,Vidyapati Nagar,35,152916,80391,72525
10,221,01297,SUB-DISTRICT,Dalsinghsarai,45,184956,96716,88240
10,221,01298,SUB-DISTRICT,Ujiarpur,61,297811,156349,141462
10,221,01299,SUB-DISTRICT,Bibhutpur,43,338149,176174,161975
10,221,01300,SUB-DISTRICT,Rosera,40,169469,88718,80751
10,221,01301,SUB-DISTRICT,Singhia,44,210035,109251,100784
10,221,01302,SUB-DISTRICT,Hasanpur,76,227421,119193,108228
10,221,01303,SUB-DISTRICT,Bithan,51,148565,76735,71830
10,222,00000,DISTRICT,Begusarai,694,2400718,1266308,1134410
10,222,01304,SUB-DISTRICT,Khudabandpur,21,90358,47074,43284
10,222,01305,SUB-DISTRICT,Chhorahi,35,124191,64686,59505
10,222,01306,SUB-DISTRICT,Garhpura,32,111108,58422,52686
10,222,01307,SUB-DISTRICT,Cheria Bariarpur,27,146680,76665,70015
10,222,01308,SUB-DISTRICT,Bhagwanpur,92,172676,91222,81454
10,222,01309,SUB-DISTRICT,Mansurchak,36,75151,38911,36240
10,222,01310,SUB-DISTRICT,Bachhwara,56,195815,103183,92632
10,222,01311,SUB-DISTRICT,Teghra,40,129857,68568,61289
10,222,01312,SUB-DISTRICT,Barauni,59,185821,98353,87468
10,222,01313,SUB-DISTRICT,Birpur,27,97467,51630,45837
10,222,01314,SUB-DISTRICT,Begusarai,56,278625,148102,130523
10,222,01315,SUB-DISTRICT,Naokothi,27,103357,53739,49618
10,222,01316,SUB-DISTRICT,Bakhri,51,100054,52292,47762
10,222,01317,SUB-DISTRICT,Dandari,18,77256,40526,36730
10,222,01318,SUB-DISTRICT,Sahebpur Kamal,31,194172,103675,90497
10,222,01319,SUB-DISTRICT,Balia,45,134628,71815,62813
10,222,01320,SUB-DISTRICT,Matihani,34,152725,81287,71438
10,222,01321,SUB-DISTRICT,Shamho Akha Kurha,7,30777,16158,14619
10,223,00000,DISTRICT,Khagaria,245,1579727,837281,742446
10,223,01322,SUB-DISTRICT,Alauli,44,282127,147972,134155
10,223,01323,SUB-DISTRICT,Khagaria,46,331952,176129,155823
10,223,01324,SUB-DISTRICT,Mansi,10,88511,47321,41190
10,223,01325,SUB-DISTRICT,Chautham,28,153831,81649,72182
10,223,01326,SUB-DISTRICT,Beldaur,29,200223,105197,95026
10,223,01327,SUB-DISTRICT,Gogri,42,279017,148875,130142
10,223,01328,SUB-DISTRICT,Parbatta,46,244066,130138,113928
10,224,00000,DISTRICT,Bhagalpur,966,2435234,1295386,1139848
10,224,01329,SUB-DISTRICT,Narayanpur,15,106701,57127,49574
10,224,01330,SUB-DISTRICT,Bihpur,23,123386,65664,57722
10,224,01331,SUB-DISTRICT,Kharik,21,132898,70873,62025
10,224,01332,SUB-DISTRICT,Naugachhia,12,105359,55994,49365
10,224,01333,SUB-DISTRICT,Rangra Chowk,9,90284,48240,42044
10,224,01334,SUB-DISTRICT,Gopalpur,9,94952,50606,44346
10,224,01335,SUB-DISTRICT,Pirpainti,92,285357,152550,132807
10,224,01336,SUB-DISTRICT,Colgong,147,329788,176176,153612
10,224,01337,SUB-DISTRICT,Ismailpur,8,43440,23285,20155
10,224,01338,SUB-DISTRICT,Sabour,46,130230,69275,60955
10,224,01339,SUB-DISTRICT,Nathnagar,91,145696,77339,68357
10,224,01340,SUB-DISTRICT,Sultanganj,74,195109,103041,92068
10,224,01341,SUB-DISTRICT,Shahkund,107,188078,100033,88045
10,224,01342,SUB-DISTRICT,Goradih,84,146210,77684,68526
10,224,01343,SUB-DISTRICT,Jagdishpur,91,125349,66237,59112
10,224,01344,SUB-DISTRICT,Sonhaula,137,192397,101262,91135
10,225,00000,DISTRICT,Banka,1702,1963450,1029097,934353
10,225,01345,SUB-DISTRICT,Shambhuganj,132,173974,92351,81623
10,225,01346,SUB-DISTRICT,Amarpur,123,201351,105705,95646
10,225,01347,SUB-DISTRICT,Rajaun,166,197601,103596,94005
10,225,01348,SUB-DISTRICT,Dhuraiya,181,239762,125586,114176
10,225,01349,SUB-DISTRICT,Barahat,65,149188,77845,71343
10,225,01350,SUB-DISTRICT,Banka,77,171324,89334,81990
10,225,01351,SUB-DISTRICT,Phulidumar,112,125251,66115,59136
10,225,01352,SUB-DISTRICT,Belhar,142,167719,87838,79881
10,225,01353,SUB-DISTRICT,Chanan,269,165634,86251,79383
10,225,01354,SUB-DISTRICT,Katoria,315,186646,98119,88527
10,225,01355,SUB-DISTRICT,Bausi,120,185000,96357,88643
10,226,00000,DISTRICT,Munger,534,987645,527299,460346
10,226,01356,SUB-DISTRICT,Munger,59,134089,71761,62328
10,226,01357,SUB-DISTRICT,Bariarpur,27,104437,56090,48347
10,226,01358,SUB-DISTRICT,Jamalpur,45,102896,54891,48005
10,226,01359,SUB-DISTRICT,Dharhara,97,131753,70489,61264
10,226,01360,SUB-DISTRICT,Kharagpur,92,180920,96353,84567
10,226,01361,SUB-DISTRICT,Asarganj,44,68053,36371,31682
10,226,01362,SUB-DISTRICT,Tarapur,53,91465,48550,42915
10,226,01363,SUB-DISTRICT,Tetiha Bambor,52,76303,40697,35606
10,226,01364,SUB-DISTRICT,Sangrampur,65,97729,52097,45632
10,227,00000,DISTRICT,Lakhisarai,362,857901,450863,407038
10,227,01365,SUB-DISTRICT,Barahiya,35,85945,45809,40136
10,227,01366,SUB-DISTRICT,Pipariya,16,51496,27369,24127
10,227,01367,SUB-DISTRICT,Surajgarha,117,290998,154509,136489
10,227,01368,SUB-DISTRICT,Lakhisarai,51,121216,63143,58073
10,227,01369,SUB-DISTRICT,Chanan*,57,107144,55859,51285
10,227,01370,SUB-DISTRICT,Ramgarh Chowk,31,85105,44056,41049
10,227,01371,SUB-DISTRICT,Halsi,55,115997,60118,55879
10,228,00000,DISTRICT,Sheikhpura,261,527340,272360,254980
10,228,01372,SUB-DISTRICT,Barbigha,43,90092,46365,43727
10,228,01373,SUB-DISTRICT,Shekhopur Sarai,26,67481,35189,32292
10,228,01374,SUB-DISTRICT,Sheikhpura,69,136084,70367,65717
10,228,01375,SUB-DISTRICT,Ghat Kusumbha,23,48346,25068,23278
10,228,01376,SUB-DISTRICT,Chewara,39,73267,37362,35905
10,228,01377,SUB-DISTRICT,Ariari,61,112070,58009,54061
10,229,00000,DISTRICT,Nalanda,1003,2419759,1257728,1162031
10,229,01378,SUB-DISTRICT,Karai Parsurai,45,73951,38305,35646
10,229,01379,SUB-DISTRICT,Nagar Nausa,44,94467,49319,45148
10,229,01380,SUB-DISTRICT,Harnaut,66,176140,92491,83649
10,229,01381,SUB-DISTRICT,Chandi,66,152156,79124,73032
10,229,01382,SUB-DISTRICT,Rahui,61,144040,73926,70114
10,229,01383,SUB-DISTRICT,Bind,29,61984,31714,30270
10,229,01384,SUB-DISTRICT,Sarmera,29,97083,50583,46500
10,229,01385,SUB-DISTRICT,Asthawan ,59,163938,84532,79406
10,229,01386,SUB-DISTRICT,Bihar,72,197221,102453,94768
10,229,01387,SUB-DISTRICT,Noorsarai,60,172351,89560,82791
10,229,01388,SUB-DISTRICT,Tharthari ,30,68393,35785,32608
10,229,01389,SUB-DISTRICT,Parbalpur,23,70316,36686,33630
10,229,01390,SUB-DISTRICT,Hilsa,57,146257,76172,70085
10,229,01391,SUB-DISTRICT,Ekangarsarai,88,164542,85859,78683
10,229,01392,SUB-DISTRICT,Islampur,91,196696,102578,94118
10,229,01393,SUB-DISTRICT,Ben,32,87387,45549,41838
10,229,01394,SUB-DISTRICT,Rajgir,49,88596,46184,42412
10,229,01395,SUB-DISTRICT,Silao,48,125575,65256,60319
10,229,01396,SUB-DISTRICT,Giriak,40,96845,50124,46721
10,229,01397,SUB-DISTRICT,Katrisarai,14,41821,21528,20293
10,230,00000,DISTRICT,Patna,1264,3323875,1746025,1577850
10,230,01398,SUB-DISTRICT,Maner,36,228930,120576,108354
10,230,01399,SUB-DISTRICT,Dinapur-Cum-Khagaul,37,134909,71235,63674
10,230,01400,SUB-DISTRICT,Patna Rural ,24,83312,44473,38839
10,230,01401,SUB-DISTRICT,Sampatchak,34,106866,56115,50751
10,230,01402,SUB-DISTRICT,Phulwari,59,164829,86729,78100
10,230,01403,SUB-DISTRICT,Bihta,86,205443,108398,97045
10,230,01404,SUB-DISTRICT,Naubatpur,97,178583,93906,84677
10,230,01405,SUB-DISTRICT,Bikram,66,147024,76806,70218
10,230,01406,SUB-DISTRICT,Dulhin Bazar,50,124966,64731,60235
10,230,01407,SUB-DISTRICT,Paliganj,113,244290,125543,118747
10,230,01408,SUB-DISTRICT,Masaurhi ,97,181413,94443,86970
10,230,01409,SUB-DISTRICT,Dhanarua,115,211376,109384,101992
10,230,01410,SUB-DISTRICT,Punpun,79,138143,71912,66231
10,230,01411,SUB-DISTRICT,Fatwah,70,147047,77492,69555
10,230,01412,SUB-DISTRICT,Daniawan ,29,75086,39416,35670
10,230,01413,SUB-DISTRICT,Khusrupur,31,93773,49255,44518
10,230,01414,SUB-DISTRICT,Bakhtiarpur,53,179485,95592,83893
10,230,01415,SUB-DISTRICT,Athmalgola,22,90964,48169,42795
10,230,01416,SUB-DISTRICT,Belchhi,24,66165,34804,31361
10,230,01417,SUB-DISTRICT,Barh,45,154878,82531,72347
10,230,01418,SUB-DISTRICT,Pandarak,55,154613,81713,72900
10,230,01419,SUB-DISTRICT,Ghoswari,20,74898,39776,35122
10,230,01420,SUB-DISTRICT,Mokameh,22,136882,73026,63856
10,231,00000,DISTRICT,Bhojpur,997,2338546,1224274,1114272
10,231,01421,SUB-DISTRICT,Shahpur,86,194486,102702,91784
10,231,01422,SUB-DISTRICT,Arrah,90,201188,106438,94750
10,231,01423,SUB-DISTRICT,Barhara,59,240636,128147,112489
10,231,01424,SUB-DISTRICT,Koilwar,60,184450,97192,87258
10,231,01425,SUB-DISTRICT,Sandesh,47,109712,57387,52325
10,231,01426,SUB-DISTRICT,Udwant Nagar,69,157809,82626,75183
10,231,01427,SUB-DISTRICT,Behea,76,151722,79125,72597
10,231,01428,SUB-DISTRICT,Jagdishpur,79,231512,121223,110289
10,231,01429,SUB-DISTRICT,Piro,100,221126,114808,106318
10,231,01430,SUB-DISTRICT,Charpokhari,73,101363,52601,48762
10,231,01431,SUB-DISTRICT,Garhani,48,103262,53820,49442
10,231,01432,SUB-DISTRICT,Agiaon,67,148373,77278,71095
10,231,01433,SUB-DISTRICT,Tarari,92,182631,94829,87802
10,231,01434,SUB-DISTRICT,Sahar,51,110276,56098,54178
10,232,00000,DISTRICT,Buxar,835,1541853,801086,740767
10,232,01435,SUB-DISTRICT,Simri,94,207225,108579,98646
10,232,01436,SUB-DISTRICT,Chakki,10,42256,21810,20446
10,232,01437,SUB-DISTRICT,Barhampur,65,196070,101997,94073
10,232,01438,SUB-DISTRICT,Chaugain,20,48743,25021,23722
10,232,01439,SUB-DISTRICT,Kesath ,15,33820,17415,16405
10,232,01440,SUB-DISTRICT,Dumraon ,73,179064,92871,86193
10,232,01441,SUB-DISTRICT,Buxar,97,180308,94928,85380
10,232,01442,SUB-DISTRICT,Chausa,57,103670,54102,49568
10,232,01443,SUB-DISTRICT,Rajpur,176,213534,110934,102600
10,232,01444,SUB-DISTRICT,Itarhi,133,170629,88073,82556
10,232,01445,SUB-DISTRICT,Nawanagar,95,166534,85356,81178
10,233,00000,DISTRICT,Kaimur (Bhabua),1337,1560813,812298,748515
10,233,01446,SUB-DISTRICT,Ramgarh,91,123973,64270,59703
10,233,01447,SUB-DISTRICT,Nuaon,69,106530,55931,50599
10,233,01448,SUB-DISTRICT,Kudra,131,165145,86395,78750
10,233,01449,SUB-DISTRICT,Mohania,157,218479,114213,104266
10,233,01450,SUB-DISTRICT,Durgawati,91,136962,70786,66176
10,233,01451,SUB-DISTRICT,Chand,114,133682,69587,64095
10,233,01452,SUB-DISTRICT,Chainpur,151,187692,96821,90871
10,233,01453,SUB-DISTRICT,Bhabua,217,251261,131156,120105
10,233,01454,SUB-DISTRICT,Rampur,101,88876,46122,42754
10,233,01455,SUB-DISTRICT,Bhagwanpur,107,91113,47371,43742
10,233,01456,SUB-DISTRICT,Adhaura,108,57100,29646,27454
10,234,00000,DISTRICT,Rohtas,1717,2532153,1318276,1213877
10,234,01457,SUB-DISTRICT,Kochas,148,170025,88726,81299
10,234,01458,SUB-DISTRICT,Dinara,181,225468,117073,108395
10,234,01459,SUB-DISTRICT,Dawath,60,89565,46076,43489
10,234,01460,SUB-DISTRICT,Suryapura,40,57529,29994,27535
10,234,01461,SUB-DISTRICT,Bikramganj,80,115100,60243,54857
10,234,01462,SUB-DISTRICT,Karakat,128,209284,109007,100277
10,234,01463,SUB-DISTRICT,Nasriganj,50,115117,59590,55527
10,234,01464,SUB-DISTRICT,Rajpur,36,75213,39280,35933
10,234,01465,SUB-DISTRICT,Sanjhauli,41,62621,32692,29929
10,234,01466,SUB-DISTRICT,Nokha,81,146025,76179,69846
10,234,01467,SUB-DISTRICT,Kargahar,198,225082,117949,107133
10,234,01468,SUB-DISTRICT,Chenari,111,119642,62340,57302
10,234,01469,SUB-DISTRICT,Nauhatta,65,94065,49103,44962
10,234,01470,SUB-DISTRICT,Sheosagar,153,176080,91268,84812
10,234,01471,SUB-DISTRICT,Sasaram,144,210875,109857,101018
10,234,01472,SUB-DISTRICT,Akorhi Gola,53,120145,62634,57511
10,234,01473,SUB-DISTRICT,Dehri,58,137783,71593,66190
10,234,01474,SUB-DISTRICT,Tilouthu,57,100989,52780,48209
10,234,01475,SUB-DISTRICT,Rohtas,33,81545,41892,39653
10,235,00000,DISTRICT,Aurangabad,1742,2303219,1194619,1108600
10,235,01476,SUB-DISTRICT,Daudnagar,60,154490,79973,74517
10,235,01477,SUB-DISTRICT,Haspura,70,152880,79175,73705
10,235,01478,SUB-DISTRICT,Goh,164,234400,121939,112461
10,235,01479,SUB-DISTRICT,Rafiganj,210,276831,144080,132751
10,235,01480,SUB-DISTRICT,Obra,143,211221,109690,101531
10,235,01481,SUB-DISTRICT,Aurangabad,157,180949,94277,86672
10,235,01482,SUB-DISTRICT,Barun,185,200052,103848,96204
10,235,01483,SUB-DISTRICT,Nabinagar,300,281252,146130,135122
10,235,01484,SUB-DISTRICT,Kutumba,216,226599,116866,109733
10,235,01485,SUB-DISTRICT,Deo,116,173216,89280,83936
10,235,01486,SUB-DISTRICT,Madanpur,121,211329,109361,101968
10,236,00000,DISTRICT,Gaya,2682,3809817,1960592,1849225
10,236,01487,SUB-DISTRICT,Konch,127,201920,105286,96634
10,236,01488,SUB-DISTRICT,Tikari ,149,239187,124097,115090
10,236,01489,SUB-DISTRICT,Belaganj,113,222003,114912,107091
10,236,01490,SUB-DISTRICT,Khizirsarai,102,176048,90269,85779
10,236,01491,SUB-DISTRICT,Neem Chak Bathani,38,98603,50880,47723
10,236,01492,SUB-DISTRICT,Muhra,49,100820,51813,49007
10,236,01493,SUB-DISTRICT,Atri,54,82296,42548,39748
10,236,01494,SUB-DISTRICT,Manpur,77,148418,76700,71718
10,236,01495,SUB-DISTRICT,Gaya Town C.D.Block,85,170969,88132,82837
10,236,01496,SUB-DISTRICT,Paraiya,77,101969,52771,49198
10,236,01497,SUB-DISTRICT,Guraru,74,134194,69860,64334
10,236,01498,SUB-DISTRICT,Gurua,170,184286,94987,89299
10,236,01499,SUB-DISTRICT,Amas,97,105027,54058,50969
10,236,01500,SUB-DISTRICT,Banke Bazar,96,129624,66796,62828
10,236,01501,SUB-DISTRICT,Imamganj,184,192812,99143,93669
10,236,01502,SUB-DISTRICT,Dumaria,111,128699,66786,61913
10,236,01503,SUB-DISTRICT,Sherghati,82,114759,59136,55623
10,236,01504,SUB-DISTRICT,Dobhi,118,155413,79146,76267
10,236,01505,SUB-DISTRICT,Bodh Gaya,132,197804,101323,96481
10,236,01506,SUB-DISTRICT,Tan Kuppa,98,124940,64161,60779
10,236,01507,SUB-DISTRICT,Wazirganj,138,221731,113601,108130
10,236,01508,SUB-DISTRICT,Fatehpur,158,235612,120884,114728
10,236,01509,SUB-DISTRICT,Mohanpur,212,200149,100848,99301
10,236,01510,SUB-DISTRICT,Barachatti,141,142534,72455,70079
10,237,00000,DISTRICT,Nawada,955,2003567,1031656,971911
10,237,01511,SUB-DISTRICT,Nardiganj,54,124716,64390,60326
10,237,01512,SUB-DISTRICT,Nawada,67,202723,104900,97823
10,237,01513,SUB-DISTRICT,Warisaliganj,68,153067,79533,73534
10,237,01514,SUB-DISTRICT,Kashi Chak,27,71886,37671,34215
10,237,01515,SUB-DISTRICT,Pakribarawan,64,183066,94871,88195
10,237,01516,SUB-DISTRICT,Kawakol,46,143439,72416,71023
10,237,01517,SUB-DISTRICT,Roh,72,162507,83964,78543
10,237,01518,SUB-DISTRICT,Gobindpur,64,95454,48475,46979
10,237,01519,SUB-DISTRICT,Akbarpur,145,237292,122796,114496
10,237,01520,SUB-DISTRICT,Hisua,48,108489,55773,52716
10,237,01521,SUB-DISTRICT,Narhat,61,112042,57453,54589
10,237,01522,SUB-DISTRICT,Meskaur,57,94358,47681,46677
10,237,01523,SUB-DISTRICT,Sirdala,80,178472,91592,86880
10,237,01524,SUB-DISTRICT,Rajauli,102,136056,70141,65915
10,238,00000,DISTRICT,Jamui,1324,1615072,839776,775296
10,238,01525,SUB-DISTRICT,Islamnagar Aliganj,62,136768,70903,65865
10,238,01526,SUB-DISTRICT,Sikandra,64,148711,76782,71929
10,238,01527,SUB-DISTRICT,Jamui,71,144757,75254,69503
10,238,01528,SUB-DISTRICT,Barhat,34,92207,48141,44066
10,238,01529,SUB-DISTRICT,Lakshmipur,67,124149,64688,59461
10,238,01530,SUB-DISTRICT,Jhajha,175,215386,111775,103611
10,238,01531,SUB-DISTRICT,Gidhaur,20,77558,40720,36838
10,238,01532,SUB-DISTRICT,Khaira,89,235761,123188,112573
10,238,01533,SUB-DISTRICT,Sono,210,204587,105535,99052
10,238,01534,SUB-DISTRICT,Chakai,532,235188,122790,112398
10,239,00000,DISTRICT,Jehanabad ,541,990117,514154,475963
10,239,01535,SUB-DISTRICT,Ratni Faridpur,88,146586,76434,70152
10,239,01536,SUB-DISTRICT,Jehanabad,100,151551,79027,72524
10,239,01537,SUB-DISTRICT,Kako,93,173487,90005,83482
10,239,01538,SUB-DISTRICT,Modanganj,52,87718,45359,42359
10,239,01539,SUB-DISTRICT,Ghoshi,50,108130,55873,52257
10,239,01540,SUB-DISTRICT,Makhdumpur,110,228160,118145,110015
10,239,01541,SUB-DISTRICT,Hulasganj,48,94485,49311,45174
10,240,00000,DISTRICT,Arwal,299,648994,336420,312574
10,240,01542,SUB-DISTRICT,Arwal,50,107837,56123,51714
10,240,01543,SUB-DISTRICT,Kaler,59,148941,76872,72069
10,240,01544,SUB-DISTRICT,Karpi,82,192213,99915,92298
10,240,01545,SUB-DISTRICT,Sonbhadra Banshi Suryapur,43,78185,40220,37965
10,240,01546,SUB-DISTRICT,Kurtha,65,121818,63290,58528
11,000,00000,STATE,SIKKIM,425,456999,242797,214202
11,241,00000,DISTRICT,North  District,52,39065,22274,16791
11,241,01547,SUB-DISTRICT,Tshungthang,8,10038,6932,3106
11,241,01548,SUB-DISTRICT,Mangan,44,29027,15342,13685
11,242,00000,DISTRICT,West District,119,131187,67528,63659
11,242,01549,SUB-DISTRICT,Gyalshing,68,67662,35123,32539
11,242,01550,SUB-DISTRICT,Soreng,51,63525,32405,31120
11,243,00000,DISTRICT,South District,140,125651,65848,59803
11,243,01551,SUB-DISTRICT,Namchi,94,77696,40517,37179
11,243,01552,SUB-DISTRICT,Ravong,46,47955,25331,22624
11,244,00000,DISTRICT,East District,114,161096,87147,73949
11,244,01553,SUB-DISTRICT,Gangtok,70,102846,57118,45728
11,244,01554,SUB-DISTRICT,Pakyong,27,36392,18795,17597
11,244,01555,SUB-DISTRICT,Rongli,17,21858,11234,10624
12,000,00000,STATE,ARUNACHAL PRADESH,5258,1066358,546011,520347
12,245,00000,DISTRICT,Tawang,218,38775,20792,17983
12,245,01556,SUB-DISTRICT,Zemithang,18,2926,1439,1487
12,245,01557,SUB-DISTRICT,Lumla,21,6172,3055,3117
12,245,01558,SUB-DISTRICT,Dudunghar,26,2833,1449,1384
12,245,01559,SUB-DISTRICT,Tawang,63,7897,4104,3793
12,245,01560,SUB-DISTRICT,Kitpi,31,2935,1411,1524
12,245,01561,SUB-DISTRICT,Jang,8,5480,3288,2192
12,245,01562,SUB-DISTRICT,Lhou ,25,4029,2606,1423
12,245,01563,SUB-DISTRICT,Mukto,7,3655,1926,1729
12,245,01564,SUB-DISTRICT,Bongkhar ,14,1256,575,681
12,245,01565,SUB-DISTRICT,Thingbu,5,1592,939,653
12,246,00000,DISTRICT,West Kameng,260,68015,37809,30206
12,246,01566,SUB-DISTRICT,Dirang ,81,14651,7776,6875
12,246,01567,SUB-DISTRICT,Thembang ,11,1334,688,646
12,246,01568,SUB-DISTRICT,Nafra ,34,7403,3817,3586
12,246,01569,SUB-DISTRICT,Bomdila,2,1422,702,720
12,246,01570,SUB-DISTRICT,Kalaktang ,24,6622,3369,3253
12,246,01571,SUB-DISTRICT,Shergaon ,7,3077,1628,1449
12,246,01572,SUB-DISTRICT,Rupa ,20,2937,1521,1416
12,246,01573,SUB-DISTRICT,Singchung ,30,14534,9260,5274
12,246,01574,SUB-DISTRICT,Jamiri ,13,4998,3372,1626
12,246,01575,SUB-DISTRICT,Thrizino ,20,4863,2412,2451
12,246,01576,SUB-DISTRICT,Bhalukpong,7,5042,2677,2365
12,246,01577,SUB-DISTRICT,Kamengbari-Doimara,3,316,160,156
12,246,01578,SUB-DISTRICT,Balemu ,8,816,427,389
12,247,00000,DISTRICT,East Kameng,356,60340,29506,30834
12,247,01579,SUB-DISTRICT,Seijosa ,19,3958,1970,1988
12,247,01580,SUB-DISTRICT,Dissing-Passo ,15,1561,812,749
12,247,01581,SUB-DISTRICT,Pakke-Kessang ,21,3609,1705,1904
12,247,01582,SUB-DISTRICT,Pizirang(Veo),29,6230,3056,3174
12,247,01583,SUB-DISTRICT,Richukrong,25,3636,1805,1831
12,247,01584,SUB-DISTRICT,Seppa ,51,10864,5142,5722
12,247,01585,SUB-DISTRICT,Lada ,25,3189,1640,1549
12,247,01586,SUB-DISTRICT,Bameng ,35,5549,2765,2784
12,247,01587,SUB-DISTRICT,Pipu-Dipu ,29,3852,1828,2024
12,247,01588,SUB-DISTRICT,Gyawe Purang ,17,2469,1190,1279
12,247,01589,SUB-DISTRICT,Khenewa ,24,4230,2089,2141
12,247,01590,SUB-DISTRICT,Chayangtajo ,35,6937,3383,3554
12,247,01591,SUB-DISTRICT,Sawa ,31,4256,2121,2135
12,248,00000,DISTRICT,Papum Pare,455,79610,39935,39675
12,248,01592,SUB-DISTRICT,Balijan,26,6679,3221,3458
12,248,01593,SUB-DISTRICT,Banderdawa ,50,8523,4372,4151
12,248,01594,SUB-DISTRICT,Sangdupota (Besar Nello),45,4053,1982,2071
12,248,01595,SUB-DISTRICT,Taraso ,28,2507,1205,1302
12,248,01596,SUB-DISTRICT,Itanagar ,21,5811,2968,2843
12,248,01597,SUB-DISTRICT,Naharlagun ,32,12948,6497,6451
12,248,01598,SUB-DISTRICT,Doimukh ,25,9479,4713,4766
12,248,01599,SUB-DISTRICT,Gumto ,6,1638,809,829
12,248,01600,SUB-DISTRICT,Toru,36,3006,1454,1552
12,248,01601,SUB-DISTRICT,Sagalee,53,4734,2248,2486
12,248,01602,SUB-DISTRICT,Parang ,17,1655,807,848
12,248,01603,SUB-DISTRICT,Leporiang,41,4139,1937,2202
12,248,01604,SUB-DISTRICT,Mengio,43,6055,2896,3159
12,248,01605,SUB-DISTRICT,Kimin ,23,6756,3972,2784
12,248,01606,SUB-DISTRICT,Kakoi,9,1627,854,773
12,249,00000,DISTRICT,Upper Subansiri,543,70043,34840,35203
12,249,01607,SUB-DISTRICT,Taksing,14,1295,640,655
12,249,01608,SUB-DISTRICT,Limeking ,22,1683,868,815
12,249,01609,SUB-DISTRICT,Nacho ,51,5151,2586,2565
12,249,01610,SUB-DISTRICT,Siyum ,47,6866,3434,3432
12,249,01611,SUB-DISTRICT,Taliha ,86,13299,6610,6689
12,249,01612,SUB-DISTRICT,Payeng ,20,2246,1103,1143
12,249,01613,SUB-DISTRICT,Giba,34,5013,2383,2630
12,249,01614,SUB-DISTRICT,Chetam (Peer Yapu),57,6603,3303,3300
12,249,01615,SUB-DISTRICT,Daporijo ,46,6294,3084,3210
12,249,01616,SUB-DISTRICT,Puchi Geko ,49,4418,2181,2237
12,249,01617,SUB-DISTRICT,Dumporijo ,17,4907,2434,2473
12,249,01618,SUB-DISTRICT,Gussar ,35,4017,2036,1981
12,249,01619,SUB-DISTRICT,Gite-Ripa ,24,2623,1293,1330
12,249,01620,SUB-DISTRICT,Baririjo ,18,2475,1271,1204
12,249,01621,SUB-DISTRICT,Maro ,23,3153,1614,1539
12,250,00000,DISTRICT,West Siang,444,87306,44687,42619
12,250,01622,SUB-DISTRICT,Mechuka,33,5091,2697,2394
12,250,01623,SUB-DISTRICT,Monigong ,46,4472,2234,2238
12,250,01624,SUB-DISTRICT,Pidi,13,1036,510,526
12,250,01625,SUB-DISTRICT,Payum ,15,2354,1189,1165
12,250,01626,SUB-DISTRICT,Tato ,20,2711,1382,1329
12,250,01627,SUB-DISTRICT,Kaying ,12,5094,2878,2216
12,250,01628,SUB-DISTRICT,Darak ,11,1303,645,658
12,250,01629,SUB-DISTRICT,Kamba,27,6014,3063,2951
12,250,01630,SUB-DISTRICT,Rumgong,8,3144,1668,1476
12,250,01631,SUB-DISTRICT,Jomlo Mobuk ,16,3996,2040,1956
12,250,01632,SUB-DISTRICT,Liromoba ,25,4235,2127,2108
12,250,01633,SUB-DISTRICT,Yomcha,14,2315,1153,1162
12,250,01634,SUB-DISTRICT,Aalo ,44,14232,7117,7115
12,250,01635,SUB-DISTRICT,Tirbin,30,5662,2949,2713
12,250,01636,SUB-DISTRICT,Basar ,29,7940,3958,3982
12,250,01637,SUB-DISTRICT,Daring ,12,2266,1182,1084
12,250,01638,SUB-DISTRICT,Gensi ,12,1783,903,880
12,250,01639,SUB-DISTRICT,Sibe ,14,1345,739,606
12,250,01640,SUB-DISTRICT,Likabali ,23,6076,3142,2934
12,250,01641,SUB-DISTRICT,Kangku ,24,2500,1230,1270
12,250,01642,SUB-DISTRICT,Bagra ,16,3737,1881,1856
12,251,00000,DISTRICT,East Siang,150,71579,36147,35432
12,251,01643,SUB-DISTRICT,Boleng ,10,2797,1475,1322
12,251,01644,SUB-DISTRICT,Riga,7,4153,2175,1978
12,251,01645,SUB-DISTRICT,Pangin,8,3411,1710,1701
12,251,01646,SUB-DISTRICT,Kebang ,10,1629,761,868
12,251,01647,SUB-DISTRICT,Rebo-Perging ,7,2363,1217,1146
12,251,01648,SUB-DISTRICT,Koyu ,12,2005,1036,969
12,251,01649,SUB-DISTRICT,Kora ,5,884,466,418
12,251,01650,SUB-DISTRICT,Nari ,8,4989,2474,2515
12,251,01651,SUB-DISTRICT,New Seren ,8,3048,1554,1494
12,251,01652,SUB-DISTRICT,Bilat ,8,4734,2405,2329
12,251,01653,SUB-DISTRICT,Ruksin ,10,5679,2758,2921
12,251,01654,SUB-DISTRICT,Sille-Oyan,12,9715,4950,4765
12,251,01655,SUB-DISTRICT,Pasighat ,26,11698,5785,5913
12,251,01656,SUB-DISTRICT,Mebo ,10,7015,3601,3414
12,251,01657,SUB-DISTRICT,Namsing ,9,7459,3780,3679
12,252,00000,DISTRICT,Upper Siang,98,28780,15335,13445
12,252,01658,SUB-DISTRICT,Tuting,13,5207,3156,2051
12,252,01659,SUB-DISTRICT,Migging,5,857,441,416
12,252,01660,SUB-DISTRICT,Palling,5,613,306,307
12,252,01661,SUB-DISTRICT,Gelling,6,780,391,389
12,252,01662,SUB-DISTRICT,Singa,13,988,497,491
12,252,01663,SUB-DISTRICT,Yingkiong,6,2033,1017,1016
12,252,01664,SUB-DISTRICT,Jengging,11,3293,1821,1472
12,252,01665,SUB-DISTRICT,Geku,13,4445,2220,2225
12,252,01666,SUB-DISTRICT,Mariyang,14,6260,3252,3008
12,252,01667,SUB-DISTRICT,Mopom ( Adipasi ),4,1360,703,657
12,252,01668,SUB-DISTRICT,Katan ,8,2944,1531,1413
12,253,00000,DISTRICT,Changlang,347,128998,66283,62715
12,253,01669,SUB-DISTRICT,Khimiyong,14,3012,1553,1459
12,253,01670,SUB-DISTRICT,Yatdam,19,2793,1474,1319
12,253,01671,SUB-DISTRICT,Changlang,55,7495,3835,3660
12,253,01672,SUB-DISTRICT,Namtok,17,3875,1992,1883
12,253,01673,SUB-DISTRICT,Manmao,17,2632,1472,1160
12,253,01674,SUB-DISTRICT,Renuk,6,715,353,362
12,253,01675,SUB-DISTRICT,Lyngok-Longtoi,6,757,385,372
12,253,01676,SUB-DISTRICT,Nampong,23,3636,1890,1746
12,253,01677,SUB-DISTRICT,Tikhak Rima Putok,16,1344,716,628
12,253,01678,SUB-DISTRICT,Jairampur,13,2653,1420,1233
12,253,01679,SUB-DISTRICT,Vijoynagar,14,4438,2222,2216
12,253,01680,SUB-DISTRICT,Miao,44,20080,10260,9820
12,253,01681,SUB-DISTRICT,Kharsang,30,14516,7578,6938
12,253,01682,SUB-DISTRICT,Diyun,31,32007,16277,15730
12,253,01683,SUB-DISTRICT,Bordumsa,42,29045,14856,14189
12,254,00000,DISTRICT,Tirap,189,91165,46185,44980
12,254,01684,SUB-DISTRICT,Namsang,19,4810,2702,2108
12,254,01685,SUB-DISTRICT,Soha,12,3082,1562,1520
12,254,01686,SUB-DISTRICT,Khonsa,52,16367,8346,8021
12,254,01687,SUB-DISTRICT,Dadam,10,5074,2608,2466
12,254,01688,SUB-DISTRICT,Kanubari,15,7152,3610,3542
12,254,01689,SUB-DISTRICT,Lawnu,17,4946,2480,2466
12,254,01690,SUB-DISTRICT,Longding,14,12663,6202,6461
12,254,01691,SUB-DISTRICT,Pumao,5,4934,2454,2480
12,254,01692,SUB-DISTRICT,Pangchao,13,11808,5928,5880
12,254,01693,SUB-DISTRICT,Wakka,13,11216,5778,5438
12,254,01694,SUB-DISTRICT,Laju,19,9113,4515,4598
12,255,00000,DISTRICT,Lower Subansiri,536,70224,35460,34764
12,255,01695,SUB-DISTRICT,Ziro (Sadar) ,136,9941,4969,4972
12,255,01696,SUB-DISTRICT,Old Ziro ,83,19605,9994,9611
12,255,01697,SUB-DISTRICT,Yachuli,57,8566,4393,4173
12,255,01698,SUB-DISTRICT,Yazali ,66,9663,4925,4738
12,255,01699,SUB-DISTRICT,Pistana ,57,7170,3539,3631
12,255,01700,SUB-DISTRICT,Kamporijo ,79,6951,3447,3504
12,255,01701,SUB-DISTRICT,Dollungmukh ,19,2944,1542,1402
12,255,01702,SUB-DISTRICT,Raga ,39,5384,2651,2733
12,256,00000,DISTRICT,Kurung Kumey,700,89731,44072,45659
12,256,01703,SUB-DISTRICT,Palin ,70,9896,4901,4995
12,256,01704,SUB-DISTRICT,Yangte,39,6910,3446,3464
12,256,01705,SUB-DISTRICT,Sangram ,70,10832,5255,5577
12,256,01706,SUB-DISTRICT,Nyapin ,42,6651,3291,3360
12,256,01707,SUB-DISTRICT,Phassang ,28,2435,1163,1272
12,256,01708,SUB-DISTRICT,Koloriang ,66,5082,2483,2599
12,256,01709,SUB-DISTRICT,Chambang,56,5347,2608,2739
12,256,01710,SUB-DISTRICT,Gangte ,67,5369,2524,2845
12,256,01711,SUB-DISTRICT,Tarak-Lengdi,32,3401,1662,1739
12,256,01712,SUB-DISTRICT,Sarli,38,3120,1582,1538
12,256,01713,SUB-DISTRICT,Parsi-Parlo,65,9152,4600,4552
12,256,01714,SUB-DISTRICT,Damin,53,5755,2850,2905
12,256,01715,SUB-DISTRICT,Longding Koling (Pipsorang) ,33,6788,3277,3511
12,256,01716,SUB-DISTRICT,Tali ,41,8993,4430,4563
12,257,00000,DISTRICT,Dibang Valley,134,5620,3098,2522
12,257,01717,SUB-DISTRICT,Mipi,15,592,344,248
12,257,01718,SUB-DISTRICT,Anini ,45,2105,1165,940
12,257,01719,SUB-DISTRICT,Etalin,34,1329,721,608
12,257,01720,SUB-DISTRICT,Anelih,17,563,281,282
12,257,01721,SUB-DISTRICT,Kronli (Arzoo circle),23,1031,587,444
12,258,00000,DISTRICT,Lower Dibang Valley,264,42691,21989,20702
12,258,01722,SUB-DISTRICT,Hunli,28,1383,727,656
12,258,01723,SUB-DISTRICT,Desali,28,864,418,446
12,258,01724,SUB-DISTRICT,Roing,146,24993,12773,12220
12,258,01725,SUB-DISTRICT,Dambuk,29,4518,2295,2223
12,258,01726,SUB-DISTRICT,Tinali ( Paglam ),13,5319,2732,2587
12,258,01727,SUB-DISTRICT,Koronu,20,5614,3044,2570
12,259,00000,DISTRICT,Lohit,286,113296,58991,54305
12,259,01728,SUB-DISTRICT,Sunpura,16,5529,2847,2682
12,259,01729,SUB-DISTRICT,Tezu,47,17136,9109,8027
12,259,01730,SUB-DISTRICT,Wakro,52,8927,4666,4261
12,259,01731,SUB-DISTRICT,Chongkham,43,21995,11716,10279
12,259,01732,SUB-DISTRICT,Namsai,30,12619,6592,6027
12,259,01733,SUB-DISTRICT,Lathao,18,8390,4353,4037
12,259,01734,SUB-DISTRICT,Piyong,26,10481,5444,5037
12,259,01735,SUB-DISTRICT,Lekang (Mahadevpur),54,28219,14264,13955
12,260,00000,DISTRICT,Anjaw,278,20185,10882,9303
12,260,01736,SUB-DISTRICT,Hayuliang,61,5772,3327,2445
12,260,01737,SUB-DISTRICT,Manchal,58,3371,1629,1742
12,260,01738,SUB-DISTRICT,Goiliang,31,1681,867,814
12,260,01739,SUB-DISTRICT,Chaglagam,16,1070,573,497
12,260,01740,SUB-DISTRICT,Metengliang,29,1608,803,805
12,260,01741,SUB-DISTRICT,Kibithoo,10,1455,1043,412
12,260,01742,SUB-DISTRICT,Walong,18,1201,673,528
12,260,01743,SUB-DISTRICT,Hawai,55,4027,1967,2060
13,000,00000,STATE,NAGALAND,1400,1407536,725472,682064
13,261,00000,DISTRICT,Mon,131,215816,113469,102347
13,261,01744,SUB-DISTRICT,Naginimora,6,2907,1541,1366
13,261,01745,SUB-DISTRICT,Tizit,16,22352,11895,10457
13,261,01746,SUB-DISTRICT,Hunta,10,8435,4347,4088
13,261,01747,SUB-DISTRICT,Shangnyu,5,6138,3126,3012
13,261,01748,SUB-DISTRICT,Mon Sadar,18,21649,11278,10371
13,261,01749,SUB-DISTRICT,Wakching,9,12738,6476,6262
13,261,01750,SUB-DISTRICT,Aboi,8,14257,7488,6769
13,261,01751,SUB-DISTRICT,Longshen,7,20311,10758,9553
13,261,01752,SUB-DISTRICT,Phomching,7,12539,6611,5928
13,261,01753,SUB-DISTRICT,Chen,9,18656,9914,8742
13,261,01754,SUB-DISTRICT,Angjangyang,11,20307,10568,9739
13,261,01755,SUB-DISTRICT,Mopong,9,15377,8242,7135
13,261,01756,SUB-DISTRICT,Tobu,4,16925,8962,7963
13,261,01757,SUB-DISTRICT,Monyakshu,12,23225,12263,10962
13,262,00000,DISTRICT,Mokokchung,107,138897,71373,67524
13,262,01758,SUB-DISTRICT,Longchem,16,8617,4363,4254
13,262,01759,SUB-DISTRICT,Alongkima,10,11947,5972,5975
13,262,01760,SUB-DISTRICT,Tuli,11,11097,5830,5267
13,262,01761,SUB-DISTRICT,Changtongya,7,9840,5093,4747
13,262,01762,SUB-DISTRICT,Chuchuyimlang,11,17832,9192,8640
13,262,01763,SUB-DISTRICT,Kubolong,10,12679,6560,6119
13,262,01764,SUB-DISTRICT,Mangkolemba,13,12957,6542,6415
13,262,01765,SUB-DISTRICT,Merangmen,10,6044,3267,2777
13,262,01766,SUB-DISTRICT,Ongpangkong,19,47884,24554,23330
13,263,00000,DISTRICT,Zunheboto,191,113160,56786,56374
13,263,01767,SUB-DISTRICT,V.K.,9,3931,2006,1925
13,263,01768,SUB-DISTRICT,Akuluto,10,6612,3408,3204
13,263,01769,SUB-DISTRICT,Suruhuto,14,13957,7209,6748
13,263,01770,SUB-DISTRICT,Asuto,27,7598,3876,3722
13,263,01771,SUB-DISTRICT,Aghunato,28,18350,9072,9278
13,263,01772,SUB-DISTRICT,Zunheboto Sadar,23,13344,6630,6714
13,263,01773,SUB-DISTRICT,Atoizu,17,8740,4320,4420
13,263,01774,SUB-DISTRICT,Akuhaito,5,3876,1988,1888
13,263,01775,SUB-DISTRICT,Pughoboto,10,8943,4454,4489
13,263,01776,SUB-DISTRICT,Ghathashi,13,7967,3984,3983
13,263,01777,SUB-DISTRICT,Satakha,19,10139,5080,5059
13,263,01778,SUB-DISTRICT,Saptiqa,5,5163,2496,2667
13,263,01779,SUB-DISTRICT,Satoi,11,4540,2263,2277
13,264,00000,DISTRICT,Wokha,151,131339,66435,64904
13,264,01780,SUB-DISTRICT,Changpang,20,5397,2767,2630
13,264,01781,SUB-DISTRICT,Aitepyong,9,16194,8357,7837
13,264,01782,SUB-DISTRICT,Bhandari,31,17124,8949,8175
13,264,01783,SUB-DISTRICT,Baghty,4,2697,1398,1299
13,264,01784,SUB-DISTRICT,Sungro,8,13046,6488,6558
13,264,01785,SUB-DISTRICT,Sanis,8,7155,3533,3622
13,264,01786,SUB-DISTRICT,Lotsu,8,6338,3197,3141
13,264,01787,SUB-DISTRICT,Ralan,17,8627,4416,4211
13,264,01788,SUB-DISTRICT,Wozhuro,10,8680,4390,4290
13,264,01789,SUB-DISTRICT,Wokha Sadar,20,23182,11397,11785
13,264,01790,SUB-DISTRICT,Englan,9,12856,6484,6372
13,264,01791,SUB-DISTRICT,Chukitong,7,10043,5059,4984
13,265,00000,DISTRICT,Dimapur ,219,180942,93435,87507
13,265,01792,SUB-DISTRICT,Niuland,32,11876,5905,5971
13,265,01793,SUB-DISTRICT,Aquqhnaqua,39,9193,4548,4645
13,265,01794,SUB-DISTRICT,Kuhoboto,23,12519,6297,6222
13,265,01795,SUB-DISTRICT,Nihokhu,10,8699,4349,4350
13,265,01796,SUB-DISTRICT,Dimapur Sadar,11,23998,12353,11645
13,265,01797,SUB-DISTRICT,Chumukedima,51,81884,42733,39151
13,265,01798,SUB-DISTRICT,Dhansiripar,32,17362,8933,8429
13,265,01799,SUB-DISTRICT,Medziphema,21,15411,8317,7094
13,266,00000,DISTRICT,Phek,117,138843,70529,68314
13,266,01800,SUB-DISTRICT,Sekruzu,9,11366,5727,5639
13,266,01801,SUB-DISTRICT,Phek Sadar,15,13203,6697,6506
13,266,01802,SUB-DISTRICT,Khuza,7,4007,2027,1980
13,266,01803,SUB-DISTRICT,Meluri,13,13890,7108,6782
13,266,01804,SUB-DISTRICT,Phor,10,5117,2680,2437
13,266,01805,SUB-DISTRICT,Phokhungri,11,3611,1848,1763
13,266,01806,SUB-DISTRICT,Chozuba,8,14836,7609,7227
13,266,01807,SUB-DISTRICT,Chetheba,9,16881,8460,8421
13,266,01808,SUB-DISTRICT,Sakraba,10,9241,4655,4586
13,266,01809,SUB-DISTRICT,Pfutsero,7,20858,10541,10317
13,266,01810,SUB-DISTRICT,Zuketsa,5,5244,2700,2544
13,266,01811,SUB-DISTRICT,Khezhakeno,2,3810,1911,1899
13,266,01812,SUB-DISTRICT,Chizami,6,10274,5204,5070
13,266,01813,SUB-DISTRICT,Razieba,5,6505,3362,3143
13,267,00000,DISTRICT,Tuensang,138,159822,82462,77360
13,267,01814,SUB-DISTRICT,Noksen,10,14182,7436,6746
13,267,01815,SUB-DISTRICT,Chare,13,11156,5767,5389
13,267,01816,SUB-DISTRICT,Longkhim,12,17306,8903,8403
13,267,01817,SUB-DISTRICT,Tuensang Sadar,6,11111,5749,5362
13,267,01818,SUB-DISTRICT,Ngoungchung,10,6111,3200,2911
13,267,01819,SUB-DISTRICT,Sangsangnyu,8,6629,3429,3200
13,267,01820,SUB-DISTRICT,Sotokur,7,10707,5423,5284
13,267,01821,SUB-DISTRICT,Noklak,9,19507,10066,9441
13,267,01822,SUB-DISTRICT,Chingmei,6,3866,1988,1878
13,267,01823,SUB-DISTRICT,Nokhu,7,6291,3319,2972
13,267,01824,SUB-DISTRICT,Panso,10,11036,5687,5349
13,267,01825,SUB-DISTRICT,Shamator,11,12726,6403,6323
13,267,01826,SUB-DISTRICT,Tsurungto,2,2132,998,1134
13,267,01827,SUB-DISTRICT,Chessore,5,5438,2815,2623
13,267,01828,SUB-DISTRICT,Mangko,7,3024,1496,1528
13,267,01829,SUB-DISTRICT,Thonoknyu,15,18600,9783,8817
13,268,00000,DISTRICT,Longleng,49,42871,22511,20360
13,268,01830,SUB-DISTRICT,Tamlu,5,5336,2785,2551
13,268,01831,SUB-DISTRICT,Namsang,9,3518,1841,1677
13,268,01832,SUB-DISTRICT,Yongnyah,11,9831,5137,4694
13,268,01833,SUB-DISTRICT,Longleng,14,15571,8162,7409
13,268,01834,SUB-DISTRICT,Sakshi,10,8615,4586,4029
13,269,00000,DISTRICT,Kiphire,90,57517,29243,28274
13,269,01835,SUB-DISTRICT,Seyochung,12,9951,4906,5045
13,269,01836,SUB-DISTRICT,Amahator,12,9075,4567,4508
13,269,01837,SUB-DISTRICT,Kiphire Sadar,8,5452,2783,2669
13,269,01838,SUB-DISTRICT,Kiusam,8,5171,2657,2514
13,269,01839,SUB-DISTRICT,Sitimi,13,4035,2002,2033
13,269,01840,SUB-DISTRICT,Longmatra,11,4723,2409,2314
13,269,01841,SUB-DISTRICT,Pungro,19,14464,7555,6909
13,269,01842,SUB-DISTRICT,Khongsa,7,4646,2364,2282
13,270,00000,DISTRICT,Kohima,105,146900,76369,70531
13,270,01843,SUB-DISTRICT,Tseminyu,32,44999,22229,22770
13,270,01844,SUB-DISTRICT,Tsogin,7,5525,2828,2697
13,270,01845,SUB-DISTRICT,Chiephobozou,18,19692,10400,9292
13,270,01846,SUB-DISTRICT,Botsa,10,6695,3346,3349
13,270,01847,SUB-DISTRICT,Kezocha,10,16467,9256,7211
13,270,01848,SUB-DISTRICT,Jakhama,10,34056,17626,16430
13,270,01849,SUB-DISTRICT,Kohima Sadar,2,2097,1107,990
13,270,01850,SUB-DISTRICT,Sechu-Zubza,16,17369,9577,7792
13,271,00000,DISTRICT,Peren,102,81429,42860,38569
13,271,01851,SUB-DISTRICT,Pedi (Ngwalwa),12,10105,5330,4775
13,271,01852,SUB-DISTRICT,Jalukie,20,19685,10434,9251
13,271,01853,SUB-DISTRICT,Athibung,20,13950,7530,6420
13,271,01854,SUB-DISTRICT,Kebai Khelma,13,3012,1564,1448
13,271,01855,SUB-DISTRICT,Nsong,8,5200,2676,2524
13,271,01856,SUB-DISTRICT,Tening,19,25864,13519,12345
13,271,01857,SUB-DISTRICT,Peren,10,3613,1807,1806
14,000,00000,STATE,MANIPUR,2515,2021640,1026884,994756
14,272,00000,DISTRICT,Senapati,669,471672,243603,228069
14,272,01858,SUB-DISTRICT,Mao-Maram,89,163380,84285,79095
14,272,01859,SUB-DISTRICT,Paomata,20,53901,27912,25989
14,272,01860,SUB-DISTRICT,Purul ,27,68123,36218,31905
14,272,01861,SUB-DISTRICT,Sadar Hills West,138,64368,32778,31590
14,272,01862,SUB-DISTRICT,Saitu-Gamphazol ,174,58536,30869,27667
14,272,01863,SUB-DISTRICT,Sadar Hills East,221,63364,31541,31823
14,273,00000,DISTRICT,Tamenglong ,174,121288,62534,58754
14,273,01864,SUB-DISTRICT,Tamenglong West,53,27742,13984,13758
14,273,01865,SUB-DISTRICT,Tamenglong North ,30,28056,14927,13129
14,273,01866,SUB-DISTRICT,Tamenglong ,34,28819,14706,14113
14,273,01867,SUB-DISTRICT,Nungba,57,36671,18917,17754
14,274,00000,DISTRICT,Churachandpur,596,255786,129659,126127
14,274,01868,SUB-DISTRICT,Tipaimukh ,40,28795,14421,14374
14,274,01869,SUB-DISTRICT,Thanlon ,49,18464,9485,8979
14,274,01870,SUB-DISTRICT,Churachandpur North,122,30616,15763,14853
14,274,01871,SUB-DISTRICT,Churachandpur,321,155781,78381,77400
14,274,01872,SUB-DISTRICT,Singngat,64,22130,11609,10521
14,275,00000,DISTRICT,Bishnupur,48,149894,75171,74723
14,275,01873,SUB-DISTRICT,Nambol  ,14,37640,18847,18793
14,275,01874,SUB-DISTRICT,Bishnupur,13,37533,18723,18810
14,275,01875,SUB-DISTRICT,Moirang,21,74721,37601,37120
14,276,00000,DISTRICT,Thoubal,87,270835,135470,135365
14,276,01876,SUB-DISTRICT,Lilong,17,58628,29353,29275
14,276,01877,SUB-DISTRICT,Thoubal ,44,125375,62668,62707
14,276,01878,SUB-DISTRICT,Kakching,26,86832,43449,43383
14,277,00000,DISTRICT,Imphal West,107,195113,96948,98165
14,277,01879,SUB-DISTRICT,Lamshang,56,71661,35637,36024
14,277,01880,SUB-DISTRICT,Patsoi ,19,49190,24368,24822
14,277,01881,SUB-DISTRICT,Lamphelpat,4,9723,4694,5029
14,277,01882,SUB-DISTRICT,Wangoi,28,64539,32249,32290
14,278,00000,DISTRICT,Imphal East,191,272906,136789,136117
14,278,01883,SUB-DISTRICT,Jiribam ,50,36495,18715,17780
14,278,01884,SUB-DISTRICT,Sawombung ,67,81561,40592,40969
14,278,01885,SUB-DISTRICT,Porompat,39,83582,42013,41569
14,278,01886,SUB-DISTRICT,Keirao Bitra,35,71268,35469,35799
14,279,00000,DISTRICT,Ukhrul,213,156811,80801,76010
14,279,01887,SUB-DISTRICT,Ukhrul North ,27,31004,15740,15264
14,279,01888,SUB-DISTRICT,Ukhurl Central,68,80191,41588,38603
14,279,01889,SUB-DISTRICT,Kamjong-Chassad,45,16717,8729,7988
14,279,01890,SUB-DISTRICT,Phungyar-Phaisat,37,16539,8511,8028
14,279,01891,SUB-DISTRICT,Ukhrul South,36,12360,6233,6127
14,280,00000,DISTRICT,Chandel,430,127335,65909,61426
14,280,01892,SUB-DISTRICT,Machi,68,19865,10035,9830
14,280,01893,SUB-DISTRICT,Tengnoupal ,95,22398,11599,10799
14,280,01894,SUB-DISTRICT,Chandel ,98,32133,16123,16010
14,280,01895,SUB-DISTRICT,Chakpikarong ,169,52939,28152,24787
15,000,00000,STATE,MIZORAM,704,525435,269135,256300
15,281,00000,DISTRICT,Mamit,86,71465,37135,34330
15,281,01896,SUB-DISTRICT,Zawlnuam,43,35571,18454,17117
15,281,01897,SUB-DISTRICT,West Phaileng,21,21309,11232,10077
15,281,01898,SUB-DISTRICT,Reiek,22,14585,7449,7136
15,282,00000,DISTRICT,Kolasib,34,37077,19097,17980
15,282,01899,SUB-DISTRICT, 'N' Thingdawl,11,12108,6217,5891
15,282,01900,SUB-DISTRICT,Bilkhawthlir,16,19341,9959,9382
15,282,01901,SUB-DISTRICT,Tlangnuam (Part),7,5628,2921,2707
15,283,00000,DISTRICT,Aizawl,94,85555,43780,41775
15,283,01902,SUB-DISTRICT,Darlawn,27,22279,11519,10760
15,283,01903,SUB-DISTRICT,Phullen,12,13303,6767,6536
15,283,01904,SUB-DISTRICT,Aibawk,22,17128,8758,8370
15,283,01901,SUB-DISTRICT,Tlangnuam (Part),10,12365,6365,6000
15,283,01905,SUB-DISTRICT,Thingsulthliah (Part),23,20480,10371,10109
15,284,00000,DISTRICT,Champhai,83,77216,39110,38106
15,284,01906,SUB-DISTRICT,Ngopa,15,18730,9543,9187
15,284,01907,SUB-DISTRICT,Khawzawl,29,22413,11313,11100
15,284,01908,SUB-DISTRICT,Champhai,10,10306,5250,5056
15,284,01909,SUB-DISTRICT,Khawbung,26,22137,11195,10942
15,284,01911,SUB-DISTRICT,East Lungdar (Part),3,3630,1809,1821
15,285,00000,DISTRICT,Serchhip,35,32918,16643,16275
15,285,01905,SUB-DISTRICT,Thingsulthliah (Part),6,5798,2921,2877
15,285,01910,SUB-DISTRICT,Serchhip,17,15825,7989,7836
15,285,01911,SUB-DISTRICT,East Lungdar (Part),12,11295,5733,5562
15,286,00000,DISTRICT,Lunglei,161,92676,47577,45099
15,286,01912,SUB-DISTRICT,West Bunghmun,35,18813,9840,8973
15,286,01913,SUB-DISTRICT,Lungsen,64,34466,17754,16712
15,286,01914,SUB-DISTRICT,Lunglei,39,20471,10516,9955
15,286,01915,SUB-DISTRICT,Hnahthial,23,18926,9467,9459
15,287,00000,DISTRICT,Lawngtlai,159,97064,49940,47124
15,287,01916,SUB-DISTRICT,Chawngte,81,45307,23457,21850
15,287,01917,SUB-DISTRICT,Lawngtlai,32,17892,9198,8694
15,287,01918,SUB-DISTRICT,S' Bungtlang ,27,17126,8847,8279
15,287,01919,SUB-DISTRICT,Sangau,19,16739,8438,8301
15,288,00000,DISTRICT,Saiha,52,31464,15853,15611
15,288,01920,SUB-DISTRICT,Tuipang,33,21043,10579,10464
15,288,01921,SUB-DISTRICT,Saiha,19,10421,5274,5147
16,000,00000,STATE,TRIPURA,863,2712464,1387173,1325291
16,289,00000,DISTRICT,West Tripura ,281,1048101,536720,511381
16,289,01922,SUB-DISTRICT,Mohanpur,20,113265,57944,55321
16,289,01923,SUB-DISTRICT,Hezamara,20,35628,17959,17669
16,289,01924,SUB-DISTRICT,Padmabil,18,35534,18030,17504
16,289,01925,SUB-DISTRICT,Khowai,13,64998,33339,31659
16,289,01926,SUB-DISTRICT,Tulashikhar,23,43459,22234,21225
16,289,01927,SUB-DISTRICT,Kalyanpur,10,46579,23692,22887
16,289,01928,SUB-DISTRICT,Teliamura,12,68269,35230,33039
16,289,01929,SUB-DISTRICT,Mungiakumi ,13,29167,14999,14168
16,289,01930,SUB-DISTRICT,Mandai,16,44670,22662,22008
16,289,01931,SUB-DISTRICT,Jirania,15,98054,50791,47263
16,289,01932,SUB-DISTRICT,Dukli,6,37849,19333,18516
16,289,01933,SUB-DISTRICT,Jampuijala,19,45682,23353,22329
16,289,01934,SUB-DISTRICT,Bishalgarh,34,154884,79235,75649
16,289,01935,SUB-DISTRICT,Boxanagar,16,51707,26735,24972
16,289,01936,SUB-DISTRICT,Melaghar,28,115867,59456,56411
16,289,01937,SUB-DISTRICT,Kathalia,18,62489,31728,30761
16,290,00000,DISTRICT,South Tripura ,268,752970,384787,368183
16,290,01938,SUB-DISTRICT,Killa,16,40912,20464,20448
16,290,01939,SUB-DISTRICT,Amarpur,21,56572,29162,27410
16,290,01940,SUB-DISTRICT,Ompi,20,38635,19636,18999
16,290,01941,SUB-DISTRICT,Matarbari,30,93774,48164,45610
16,290,01942,SUB-DISTRICT,Kakraban,19,75295,38353,36942
16,290,01943,SUB-DISTRICT,Rajnagar,29,94211,48352,45859
16,290,01944,SUB-DISTRICT,Hrishyamukh,17,52736,27143,25593
16,290,01945,SUB-DISTRICT,Bokafa ,39,125457,64216,61241
16,290,01946,SUB-DISTRICT,Karbuk,18,40077,20400,19677
16,290,01947,SUB-DISTRICT,Rupaichhari,29,47946,24449,23497
16,290,01948,SUB-DISTRICT,Satchand,30,87355,44448,42907
16,291,00000,DISTRICT,Dhalai,148,337731,173773,163958
16,291,01949,SUB-DISTRICT,Salema,44,114455,58265,56190
16,291,01950,SUB-DISTRICT,Manu,22,75679,39088,36591
16,291,01951,SUB-DISTRICT,Ambassa,35,54618,28040,26578
16,291,01952,SUB-DISTRICT,Chhamanu,13,33579,17745,15834
16,291,01953,SUB-DISTRICT,Dumburnagar,34,59400,30635,28765
16,292,00000,DISTRICT,North Tripura,166,573662,291893,281769
16,292,01954,SUB-DISTRICT,Gournagar,39,108711,55254,53457
16,292,01955,SUB-DISTRICT,Kadamtala,20,123298,62269,61029
16,292,01956,SUB-DISTRICT,Panisagar,22,88046,44919,43127
16,292,01957,SUB-DISTRICT,Damchhara,11,27635,14056,13579
16,292,01958,SUB-DISTRICT,Pencharthal,17,43146,22048,21098
16,292,01959,SUB-DISTRICT,Kumarghat,22,83819,42525,41294
16,292,01960,SUB-DISTRICT,Dasda,23,86696,44407,42289
16,292,01961,SUB-DISTRICT,Jampuii hills,12,12311,6415,5896
17,000,00000,STATE,MEGHALAYA,6459,2371439,1194260,1177179
17,293,00000,DISTRICT,West Garo Hills,1577,568433,286923,281510
17,293,01962,SUB-DISTRICT,Selsella,347,175206,88349,86857
17,293,01963,SUB-DISTRICT,Dadenggiri ,127,41595,20842,20753
17,293,01964,SUB-DISTRICT,Tikrikilla ,172,58388,29267,29121
17,293,01965,SUB-DISTRICT,Rongram,173,58898,29878,29020
17,293,01966,SUB-DISTRICT,Betasing ,201,72103,36340,35763
17,293,01967,SUB-DISTRICT,Zikzak ,216,74602,37867,36735
17,293,01968,SUB-DISTRICT,Gambegre ,153,33546,17029,16517
17,293,01969,SUB-DISTRICT,Dalu ,188,54095,27351,26744
17,294,00000,DISTRICT,East Garo Hills,1058,273725,138763,134962
17,294,01970,SUB-DISTRICT,Resubelpara ,326,84919,43044,41875
17,294,01971,SUB-DISTRICT,Dambo Rongjeng ,189,52584,26634,25950
17,294,01972,SUB-DISTRICT,Kharkutta,174,51477,26055,25422
17,294,01973,SUB-DISTRICT,Songsak ,221,53107,26862,26245
17,294,01974,SUB-DISTRICT,Samanda ,148,31638,16168,15470
17,295,00000,DISTRICT,South Garo Hills,731,129203,66470,62733
17,295,01975,SUB-DISTRICT,Chokpot ,279,40478,20647,19831
17,295,01976,SUB-DISTRICT,Gasuapara ,159,28216,14480,13736
17,295,01977,SUB-DISTRICT,Baghmara ,158,37486,19456,18030
17,295,01978,SUB-DISTRICT,Rongara ,135,23023,11887,11136
17,296,00000,DISTRICT,West Khasi Hills,1093,340356,172380,167976
17,296,01979,SUB-DISTRICT,Mawshynrut,318,74490,38081,36409
17,296,01980,SUB-DISTRICT,Nongstoin,232,53098,26783,26315
17,296,01981,SUB-DISTRICT,Mawthadraishan,104,49014,24622,24392
17,296,01982,SUB-DISTRICT,Mairang,143,68074,34311,33763
17,296,01983,SUB-DISTRICT,Ranikor,158,41218,21261,19957
17,296,01984,SUB-DISTRICT,Mawkyrwat,138,54462,27322,27140
17,297,00000,DISTRICT,Ribhoi,579,233587,118705,114882
17,297,01985,SUB-DISTRICT,Umling ,200,69966,35458,34508
17,297,01986,SUB-DISTRICT,Jirang ,105,30919,15934,14985
17,297,01987,SUB-DISTRICT,Umsning ,274,132702,67313,65389
17,298,00000,DISTRICT,East Khasi Hills,923,459441,228409,231032
17,298,01988,SUB-DISTRICT,Mawphlang,184,71491,35331,36160
17,298,01989,SUB-DISTRICT,Mylliem,95,88191,43556,44635
17,298,01990,SUB-DISTRICT,Mawryngkneng,64,67291,33396,33895
17,298,01991,SUB-DISTRICT,Mawkynrew,68,44602,22118,22484
17,298,01992,SUB-DISTRICT,Khatarshnong Laitkroh,94,33570,16723,16847
17,298,01993,SUB-DISTRICT,Mawsynram,162,54109,27143,26966
17,298,01994,SUB-DISTRICT,Shella Bholaganj,123,42317,21636,20681
17,298,01995,SUB-DISTRICT,Pynursla,133,57870,28506,29364
17,299,00000,DISTRICT,Jaintia Hills,498,366694,182610,184084
17,299,01996,SUB-DISTRICT,Thadlaskein,124,109509,54230,55279
17,299,01997,SUB-DISTRICT,Laskein,87,90402,45244,45158
17,299,01998,SUB-DISTRICT,Amlarem,95,43844,21903,21941
17,299,01999,SUB-DISTRICT,Khliehriat,104,85832,42628,43204
17,299,02000,SUB-DISTRICT,Saipung,88,37107,18605,18502
18,000,00000,STATE,ASSAM,25372,26807034,13678989,13128045
18,300,00000,DISTRICT,Kokrajhar,1053,832201,424446,407755
18,300,02001,SUB-DISTRICT,Gossaigaon (Pt),301,255010,130288,124722
18,300,02002,SUB-DISTRICT,Bhowraguri,93,78061,40045,38016
18,300,02003,SUB-DISTRICT,Dotoma,172,144393,73451,70942
18,300,02004,SUB-DISTRICT,Kokrajhar (Pt),224,214095,108983,105112
18,300,02007,SUB-DISTRICT,Golokganj (Pt),41,26671,13633,13038
18,300,02008,SUB-DISTRICT,Dhubri (Pt),63,33809,17213,16596
18,300,02005,SUB-DISTRICT,Bagribari (Pt),116,51001,25929,25072
18,300,02009,SUB-DISTRICT,Bilasipara (Pt),7,8736,4530,4206
18,300,02010,SUB-DISTRICT,Chapar (Pt),36,20425,10374,10051
18,301,00000,DISTRICT,Dhubri,1052,1745557,893914,851643
18,301,02001,SUB-DISTRICT,Gossaigaon (Pt),35,53842,27487,26355
18,301,02006,SUB-DISTRICT,Agamoni,83,172146,89085,83061
18,301,02007,SUB-DISTRICT,Golokganj (Pt),101,184343,95064,89279
18,301,02008,SUB-DISTRICT,Dhubri (Pt),152,328459,169188,159271
18,301,02005,SUB-DISTRICT,Bagribari (Pt),117,140570,71922,68648
18,301,02009,SUB-DISTRICT,Bilasipara (Pt),178,218445,111992,106453
18,301,02010,SUB-DISTRICT,Chapar (Pt),106,118800,60372,58428
18,301,02011,SUB-DISTRICT,South Salmara,173,249508,127195,122313
18,301,02012,SUB-DISTRICT,Mankachar,107,279444,141609,137835
18,302,00000,DISTRICT,Goalpara,779,870121,443244,426877
18,302,02013,SUB-DISTRICT,Lakhipur,221,255994,131088,124906
18,302,02014,SUB-DISTRICT,Balijana,216,205509,104906,100603
18,302,02015,SUB-DISTRICT,Matia,153,233608,119130,114478
18,302,02016,SUB-DISTRICT,Dudhnai,64,65916,32867,33049
18,302,02017,SUB-DISTRICT,Rangjuli,125,109094,55253,53841
18,303,00000,DISTRICT,Barpeta,825,1546269,791789,754480
18,303,02018,SUB-DISTRICT,Barnagar (Pt),93,174251,88858,85393
18,303,02019,SUB-DISTRICT,Kalgachia,100,195983,101226,94757
18,303,02020,SUB-DISTRICT,Baghbor,136,306065,156890,149175
18,303,02021,SUB-DISTRICT,Chenga,68,134581,68994,65587
18,303,02022,SUB-DISTRICT,Barpeta,136,304658,156859,147799
18,303,02023,SUB-DISTRICT,Sarthebari,127,188157,96466,91691
18,303,02024,SUB-DISTRICT,Bajali (Pt),69,91183,45336,45847
18,303,02025,SUB-DISTRICT,Sarupeta (Pt),81,129853,66305,63548
18,303,02140,SUB-DISTRICT,Jalah (Pt),15,21538,10855,10683
18,304,00000,DISTRICT,Morigaon,598,884125,449123,435002
18,304,02026,SUB-DISTRICT,Mayong,172,215606,109954,105652
18,304,02027,SUB-DISTRICT,Bhuragaon,99,113624,58387,55237
18,304,02028,SUB-DISTRICT,Laharighat,100,246405,126014,120391
18,304,02029,SUB-DISTRICT,Marigaon,162,171277,86302,84975
18,304,02030,SUB-DISTRICT,Mikirbheta,65,137213,68466,68747
18,305,00000,DISTRICT,Nagaon,1361,2454234,1250985,1203249
18,305,02031,SUB-DISTRICT,Kaliabor,206,197470,100013,97457
18,305,02032,SUB-DISTRICT,Samaguri,177,322523,163773,158750
18,305,02033,SUB-DISTRICT,Rupahi,64,228206,116954,111252
18,305,02034,SUB-DISTRICT,Dhing,101,311256,159704,151552
18,305,02035,SUB-DISTRICT,Nagaon,156,258344,131469,126875
18,305,02036,SUB-DISTRICT,Raha,125,164095,82076,82019
18,305,02037,SUB-DISTRICT,Kampur,134,213472,108466,105006
18,305,02038,SUB-DISTRICT,Hojai,102,167485,85575,81910
18,305,02039,SUB-DISTRICT,Doboka,113,283272,145138,138134
18,305,02040,SUB-DISTRICT,Lanka,183,308111,157817,150294
18,306,00000,DISTRICT,Sonitpur,1798,1750265,894985,855280
18,306,02041,SUB-DISTRICT,Dhekiajuli (Pt),379,448439,230305,218134
18,306,02042,SUB-DISTRICT,Chariduar,328,325356,167104,158252
18,306,02043,SUB-DISTRICT,Tezpur,110,179527,93011,86516
18,306,02044,SUB-DISTRICT,Na-Duar,191,215820,109355,106465
18,306,02045,SUB-DISTRICT,Biswanath,352,327479,166663,160816
18,306,02046,SUB-DISTRICT,Helem,208,139852,70661,69191
18,306,02047,SUB-DISTRICT,Gohpur,230,113792,57886,55906
18,307,00000,DISTRICT,Lakhimpur,1146,950804,482582,468222
18,307,02048,SUB-DISTRICT,Narayanpur,199,129640,65382,64258
18,307,02049,SUB-DISTRICT,Bihpuria,164,198149,100667,97482
18,307,02050,SUB-DISTRICT,Naobaicha,141,148973,75537,73436
18,307,02051,SUB-DISTRICT,Kadam,152,107330,54590,52740
18,307,02052,SUB-DISTRICT,North Lakhimpur,225,190829,97407,93422
18,307,02053,SUB-DISTRICT,Dhakuakhana (Pt),156,100793,50949,49844
18,307,02054,SUB-DISTRICT,Subansiri (Pt),109,75090,38050,37040
18,308,00000,DISTRICT,Dhemaji,1264,637848,326278,311570
18,308,02055,SUB-DISTRICT,Dhemaji,268,127104,64597,62507
18,308,02056,SUB-DISTRICT,Sissibargaon,374,208368,107848,100520
18,308,02057,SUB-DISTRICT,Jonai,370,160091,82127,77964
18,308,02053,SUB-DISTRICT,Dhakuakhana (Pt-I),51,29575,14825,14750
18,308,02054,SUB-DISTRICT,Subansiri (Pt-I),30,13950,7239,6711
18,308,02058,SUB-DISTRICT,Gogamukh,171,98760,49642,49118
18,309,00000,DISTRICT,Tinsukia,1136,1063186,541395,521791
18,309,02059,SUB-DISTRICT,Sadiya,170,92129,47245,44884
18,309,02060,SUB-DISTRICT,Doom Dooma,402,378294,192009,186285
18,309,02061,SUB-DISTRICT,Tinsukia,250,305513,155261,150252
18,309,02062,SUB-DISTRICT,Margherita,314,287250,146880,140370
18,310,00000,DISTRICT,Dibrugarh,1318,1082605,550299,532306
18,310,02063,SUB-DISTRICT,Dibrugarh West,179,152231,77559,74672
18,310,02064,SUB-DISTRICT,Dibrugarh East,97,123283,62547,60736
18,310,02065,SUB-DISTRICT,Chabua,120,150619,77575,73044
18,310,02066,SUB-DISTRICT,Tengakhat,222,183100,92601,90499
18,310,02067,SUB-DISTRICT,Moran,295,161325,81884,79441
18,310,02068,SUB-DISTRICT,Tingkhong,222,159295,80447,78848
18,310,02069,SUB-DISTRICT,Naharkatiya,183,152752,77686,75066
18,311,00000,DISTRICT,Sivasagar,862,1040954,531286,509668
18,311,02070,SUB-DISTRICT,Dimow,153,152166,78000,74166
18,311,02071,SUB-DISTRICT,Sibsagar,135,147861,75319,72542
18,311,02072,SUB-DISTRICT,Amguri,109,136007,68697,67310
18,311,02073,SUB-DISTRICT,Nazira,121,176028,90140,85888
18,311,02074,SUB-DISTRICT,Sonari,226,305246,156073,149173
18,311,02075,SUB-DISTRICT,Mahmora,118,123646,63057,60589
18,312,00000,DISTRICT,Jorhat,763,871722,442968,428754
18,312,02076,SUB-DISTRICT,Majuli,192,167304,85566,81738
18,312,02077,SUB-DISTRICT,Jorhat West,129,163620,83582,80038
18,312,02078,SUB-DISTRICT,Jorhat East,60,70299,35788,34511
18,312,02079,SUB-DISTRICT,Teok,150,175816,88808,87008
18,312,02080,SUB-DISTRICT,Titabor,162,183871,93420,90451
18,312,02081,SUB-DISTRICT,Mariani,70,110812,55804,55008
18,313,00000,DISTRICT,Golaghat,1032,969152,493125,476027
18,313,02082,SUB-DISTRICT,Bokakhat,112,145845,74236,71609
18,313,02083,SUB-DISTRICT,Khumtai,69,85835,43406,42429
18,313,02084,SUB-DISTRICT,Dergaon,81,126042,64326,61716
18,313,02085,SUB-DISTRICT,Golaghat,323,285242,144898,140344
18,313,02086,SUB-DISTRICT,Morangi,97,114851,58431,56420
18,313,02087,SUB-DISTRICT,Sarupathar,350,211337,107828,103509
18,314,00000,DISTRICT,Karbi Anglong,2712,843347,431924,411423
18,314,02088,SUB-DISTRICT,Donka,547,277495,142163,135332
18,314,02089,SUB-DISTRICT,Diphu,805,205668,106883,98785
18,314,02090,SUB-DISTRICT,Phuloni,991,268927,136148,132779
18,314,02091,SUB-DISTRICT,Silonijan,369,91257,46730,44527
18,315,00000,DISTRICT,Dima Hasao,676,151613,77817,73796
18,315,02092,SUB-DISTRICT,Umrangso,197,39576,20594,18982
18,315,02093,SUB-DISTRICT,Haflong,152,32965,16926,16039
18,315,02094,SUB-DISTRICT,Mahur,130,31738,16102,15636
18,315,02095,SUB-DISTRICT,Maibong,197,47334,24195,23139
18,316,00000,DISTRICT,Cachar,998,1421153,727083,694070
18,316,02096,SUB-DISTRICT,Katigora,215,280006,144215,135791
18,316,02097,SUB-DISTRICT,Silchar,245,420198,216248,203950
18,316,02098,SUB-DISTRICT,Udarbond,86,115039,59294,55745
18,316,02099,SUB-DISTRICT,Sonai,216,324315,164471,159844
18,316,02100,SUB-DISTRICT,Lakhipur,236,281595,142855,138740
18,317,00000,DISTRICT,Karimganj,915,1118986,570510,548476
18,317,02101,SUB-DISTRICT,Karimganj,175,207087,105425,101662
18,317,02102,SUB-DISTRICT,Badarpur,80,126216,64381,61835
18,317,02103,SUB-DISTRICT,Nilambazar,177,242451,123247,119204
18,317,02104,SUB-DISTRICT,Patharkandi,199,261368,133698,127670
18,317,02105,SUB-DISTRICT,Ramkrishna Nagar,284,281864,143759,138105
18,318,00000,DISTRICT,Hailakandi,330,611156,313747,297409
18,318,02106,SUB-DISTRICT,Algapur,69,118647,61154,57493
18,318,02107,SUB-DISTRICT,Hailakandi,64,133260,68975,64285
18,318,02108,SUB-DISTRICT,Lala,87,191172,97613,93559
18,318,02109,SUB-DISTRICT,Katlichara,110,168077,86005,82072
18,319,00000,DISTRICT,Bongaigaon,535,628994,319786,309208
18,319,02110,SUB-DISTRICT,Bongaigaon (Pt),79,73877,36962,36915
18,319,02111,SUB-DISTRICT,Boitamari,125,121652,61995,59657
18,319,02112,SUB-DISTRICT,Srijangram,211,250853,128348,122505
18,319,02115,SUB-DISTRICT,Bijni (Pt),83,130242,66112,64130
18,319,02114,SUB-DISTRICT,Sidli (Pt),37,52370,26369,26001
18,320,00000,DISTRICT,Chirang,501,446825,226895,219930
18,320,02004,SUB-DISTRICT,Kokrajhar (Pt),13,8152,4140,4012
18,320,02113,SUB-DISTRICT,Bengtol,86,49941,25377,24564
18,320,02114,SUB-DISTRICT,Sidli (Pt),134,150650,76917,73733
18,320,02110,SUB-DISTRICT,Bongaigaon (Pt),6,8253,4139,4114
18,320,02115,SUB-DISTRICT,Bijni (Pt),254,220329,111566,108763
18,320,02018,SUB-DISTRICT,Barnagar (Pt),8,9500,4756,4744
18,321,00000,DISTRICT,Kamrup,1037,1375148,706140,669008
18,321,02141,SUB-DISTRICT,Goreswar (Pt),27,38061,19444,18617
18,321,02116,SUB-DISTRICT,Rangia (Pt),83,122800,63713,59087
18,321,02117,SUB-DISTRICT,Koya,28,32350,16667,15683
18,321,02118,SUB-DISTRICT,Kamalpur,116,169235,88582,80653
18,321,02119,SUB-DISTRICT,Hajo,125,221090,113992,107098
18,321,02120,SUB-DISTRICT,Chhaygaon,144,121628,61741,59887
18,321,02121,SUB-DISTRICT,Goroimari,77,134387,68426,65961
18,321,02122,SUB-DISTRICT,Chamaria,59,126604,64987,61617
18,321,02123,SUB-DISTRICT,Nagarbera,27,78280,40281,37999
18,321,02124,SUB-DISTRICT,Boko,138,111880,56415,55465
18,321,02125,SUB-DISTRICT,Palasbari,182,182428,93104,89324
18,321,02126,SUB-DISTRICT,North Guwahati (Pt),31,36405,18788,17617
18,322,00000,DISTRICT,Kamrup Metropolitan,204,216927,111062,105865
18,322,02127,SUB-DISTRICT,Azara,18,28281,15178,13103
18,322,02126,SUB-DISTRICT,North Guwahati (Pt),5,9217,4688,4529
18,322,02128,SUB-DISTRICT,Guwahati,0,0,0,0
18,322,02129,SUB-DISTRICT,Dispur,5,6309,3237,3072
18,322,02130,SUB-DISTRICT,Sonapur,138,128949,65325,63624
18,322,02131,SUB-DISTRICT,Chandrapur,38,44171,22634,21537
18,323,00000,DISTRICT,Nalbari,455,688909,353677,335232
18,323,02142,SUB-DISTRICT,Barama (Pt),5,13642,7073,6569
18,323,02132,SUB-DISTRICT,Tihu (Pt),28,63057,32026,31031
18,323,02133,SUB-DISTRICT,Pachim Nalbari,49,97791,50238,47553
18,323,02134,SUB-DISTRICT,Barkhetri,124,202196,103949,98247
18,323,02135,SUB-DISTRICT,Barbhag,59,63540,32610,30930
18,323,02136,SUB-DISTRICT,Nalbari,81,110160,56695,53465
18,323,02137,SUB-DISTRICT,Banekuchi,23,40559,20982,19577
18,323,02138,SUB-DISTRICT,Ghograpar (Pt),84,90376,46196,44180
18,323,02139,SUB-DISTRICT,Baganpara (Pt),2,7588,3908,3680
18,324,00000,DISTRICT,Baksa,679,937833,475027,462806
18,324,02018,SUB-DISTRICT,Barnagar (Pt),87,132538,67749,64789
18,324,02024,SUB-DISTRICT,Bajali (Pt),2,2994,1512,1482
18,324,02025,SUB-DISTRICT,Sarupeta (Pt),54,55011,27590,27421
18,324,02140,SUB-DISTRICT,Jalah (Pt),74,81979,40871,41108
18,324,02141,SUB-DISTRICT,Goreswar (Pt),93,148116,74988,73128
18,324,02116,SUB-DISTRICT,Rangia (Pt),6,14357,7309,7048
18,324,02142,SUB-DISTRICT,Barama (Pt),36,49715,25201,24514
18,324,02132,SUB-DISTRICT,Tihu (Pt),11,17508,8850,8658
18,324,02138,SUB-DISTRICT,Ghograpar (Pt),3,3652,1840,1812
18,324,02143,SUB-DISTRICT,Baska,85,124585,62815,61770
18,324,02139,SUB-DISTRICT,Baganpara (Pt),44,69741,35445,34296
18,324,02144,SUB-DISTRICT,Tamulpur,183,235403,119705,115698
18,324,02146,SUB-DISTRICT,Pathorighat (Pt),1,2234,1152,1082
18,325,00000,DISTRICT,Darrang,552,873006,446460,426546
18,325,02145,SUB-DISTRICT,Khoirabari (Pt),7,8398,4251,4147
18,325,02146,SUB-DISTRICT,Pathorighat (Pt),84,95338,48921,46417
18,325,02147,SUB-DISTRICT,Sipajhar,92,123498,62832,60666
18,325,02148,SUB-DISTRICT,Mangaldoi (Pt),134,165442,85576,79866
18,325,02150,SUB-DISTRICT,Kalaigaon (Pt),25,25246,12723,12523
18,325,02149,SUB-DISTRICT,Dalgaon (Pt),210,455084,232157,222927
18,326,00000,DISTRICT,Udalguri,791,794094,402442,391652
18,326,02145,SUB-DISTRICT,Khoirabari (Pt),84,81209,40983,40226
18,326,02146,SUB-DISTRICT,Pathorighat (Pt),1,1008,501,507
18,326,02148,SUB-DISTRICT,Mangaldoi (Pt),6,4799,2465,2334
18,326,02150,SUB-DISTRICT,Kalaigaon (Pt),77,80504,40982,39522
18,326,02149,SUB-DISTRICT,Dalgaon (Pt),46,52627,26808,25819
18,326,02151,SUB-DISTRICT,Harisinga,200,225493,113716,111777
18,326,02152,SUB-DISTRICT,Udalguri,222,197081,100111,96970
18,326,02153,SUB-DISTRICT,Mazbat,136,132773,67534,65239
18,326,02041,SUB-DISTRICT,Dhekiajuli (Pt),19,18600,9342,9258
19,000,00000,STATE,WEST BENGAL,37469,62183113,31844945,30338168
19,327,00000,DISTRICT,Darjiling ,616,1118860,566965,551895
19,327,02154,SUB-DISTRICT,Darjeeling Pulbazar,43,105150,53078,52072
19,327,02155,SUB-DISTRICT,Rangli Rangliot,29,70125,35025,35100
19,327,02156,SUB-DISTRICT,Kalimpong -I,43,67957,34474,33483
19,327,02157,SUB-DISTRICT,Kalimpong - II,33,66830,34546,32284
19,327,02158,SUB-DISTRICT,Gorubathan,27,60663,31054,29609
19,327,02159,SUB-DISTRICT,Jorebunglow Sukiapokhri,42,86637,42969,43668
19,327,02160,SUB-DISTRICT,Mirik,21,46374,23394,22980
19,327,02161,SUB-DISTRICT,Kurseong,65,79903,39914,39989
19,327,02162,SUB-DISTRICT,Matigara ,59,135583,69884,65699
19,327,02163,SUB-DISTRICT,Naxalbari,78,97717,49281,48436
19,327,02164,SUB-DISTRICT,Phansidewa,103,204522,103719,100803
19,327,02165,SUB-DISTRICT,Kharibari,73,97399,49627,47772
19,328,00000,DISTRICT,Jalpaiguri ,718,2812495,1437286,1375209
19,328,02166,SUB-DISTRICT,Rajganj,26,190645,99129,91516
19,328,02167,SUB-DISTRICT,Mal,100,275384,139602,135782
19,328,02168,SUB-DISTRICT,Matiali,27,102418,52476,49942
19,328,02169,SUB-DISTRICT,Nagrakata,33,127397,64133,63264
19,328,02170,SUB-DISTRICT,Madarihat,48,188265,94531,93734
19,328,02171,SUB-DISTRICT,Kalchini,41,211808,105633,106175
19,328,02172,SUB-DISTRICT,Kumargram,53,174058,89456,84602
19,328,02173,SUB-DISTRICT,Alipurduar - I,47,160760,82878,77882
19,328,02174,SUB-DISTRICT,Alipurduar - II,78,204652,105403,99249
19,328,02175,SUB-DISTRICT,Falakata,60,244161,125691,118470
19,328,02176,SUB-DISTRICT,Dhupguri,98,380090,193071,187019
19,328,02177,SUB-DISTRICT,Maynaguri,79,291073,150757,140316
19,328,02178,SUB-DISTRICT,Jalpaiguri,28,261784,134526,127258
19,329,00000,DISTRICT,Koch Bihar ,1132,2529652,1304916,1224736
19,329,02179,SUB-DISTRICT,Haldibari,57,103969,52851,51118
19,329,02180,SUB-DISTRICT,Mekliganj,137,150767,77801,72966
19,329,02181,SUB-DISTRICT,Mathabhanga - I,101,218191,112497,105694
19,329,02182,SUB-DISTRICT,Mathabhanga - II,92,227397,117100,110297
19,329,02183,SUB-DISTRICT,Cooch Behar - I,142,293267,151337,141930
19,329,02184,SUB-DISTRICT,Cooch Behar - II,111,289917,151946,137971
19,329,02185,SUB-DISTRICT,Tufanganj - I,72,243256,125672,117584
19,329,02186,SUB-DISTRICT,Tufanganj - II,53,181246,93431,87815
19,329,02187,SUB-DISTRICT,Dinhata - I,128,281890,145325,136565
19,329,02188,SUB-DISTRICT,Dinhata - II,119,244066,126663,117403
19,329,02189,SUB-DISTRICT,Sitai,53,110333,56016,54317
19,329,02190,SUB-DISTRICT,Sitalkuchi,67,185353,94277,91076
19,330,00000,DISTRICT,Uttar Dinajpur,1475,2644906,1362469,1282437
19,330,02191,SUB-DISTRICT,Chopra,116,278626,144076,134550
19,330,02192,SUB-DISTRICT,Islampur,101,308518,158933,149585
19,330,02193,SUB-DISTRICT,Goalpokhar - I,144,320181,166889,153292
19,330,02194,SUB-DISTRICT,Goalpokhar - II,169,291252,150125,141127
19,330,02195,SUB-DISTRICT,Karandighi,200,368332,188572,179760
19,330,02196,SUB-DISTRICT,Raiganj,221,414143,213393,200750
19,330,02197,SUB-DISTRICT,Hemtabad,114,142056,72624,69432
19,330,02198,SUB-DISTRICT,Kaliaganj,191,224142,115104,109038
19,330,02199,SUB-DISTRICT,Itahar,219,297656,152753,144903
19,331,00000,DISTRICT,Dakshin Dinajpur,1582,1439981,737771,702210
19,331,02200,SUB-DISTRICT,Kushmundi,228,198752,100317,98435
19,331,02201,SUB-DISTRICT,Gangarampur,198,230612,119358,111254
19,331,02202,SUB-DISTRICT,Kumarganj,208,169102,87098,82004
19,331,02203,SUB-DISTRICT,Hilli,79,83754,42981,40773
19,331,02204,SUB-DISTRICT,Balurghat,294,234139,120867,113272
19,331,02205,SUB-DISTRICT,Tapan,271,250504,128500,122004
19,331,02206,SUB-DISTRICT,Bansihari,160,141286,72161,69125
19,331,02207,SUB-DISTRICT,Harirampur,144,131832,66489,65343
19,332,00000,DISTRICT,Maldah ,1613,3447185,1768336,1678849
19,332,02208,SUB-DISTRICT,Harischandrapur - I,104,199493,103183,96310
19,332,02209,SUB-DISTRICT,Harischandrapur - II,73,251345,130367,120978
19,332,02210,SUB-DISTRICT,Chanchal - I,98,199170,102187,96983
19,332,02211,SUB-DISTRICT,Chanchal - II,90,205333,105374,99959
19,332,02212,SUB-DISTRICT,Ratua - I,95,275388,142183,133205
19,332,02213,SUB-DISTRICT,Ratua - II,48,202080,102962,99118
19,332,02214,SUB-DISTRICT,Gazole,286,332191,168635,163556
19,332,02215,SUB-DISTRICT,Bamangola,141,143906,74071,69835
19,332,02216,SUB-DISTRICT,Habibpur,233,185342,93812,91530
19,332,02217,SUB-DISTRICT,Maldah (Old),112,135855,69626,66229
19,332,02218,SUB-DISTRICT,English Bazar,108,242797,124521,118276
19,332,02219,SUB-DISTRICT,Manikchak,72,269813,139593,130220
19,332,02220,SUB-DISTRICT,Kaliachak - I,49,269058,137213,131845
19,332,02221,SUB-DISTRICT,Kaliachak - II,40,206267,105609,100658
19,332,02222,SUB-DISTRICT,Kaliachak - III,65,329147,169000,160147
19,333,00000,DISTRICT,Murshidabad ,1886,5703115,2917822,2785293
19,333,02223,SUB-DISTRICT,Farakka,56,167826,85302,82524
19,333,02224,SUB-DISTRICT,Samserganj,24,108718,54532,54186
19,333,02225,SUB-DISTRICT,Suti - I,46,150803,77047,73756
19,333,02226,SUB-DISTRICT,Suti - II,24,110767,55790,54977
19,333,02227,SUB-DISTRICT,Raghunathganj - I,56,133114,68136,64978
19,333,02228,SUB-DISTRICT,Raghunathganj - II,36,131236,67018,64218
19,333,02229,SUB-DISTRICT,Lalgola,84,335831,170997,164834
19,333,02230,SUB-DISTRICT,Sagardighi,178,310461,158641,151820
19,333,02231,SUB-DISTRICT,Bhagawangola - I,54,202071,103419,98652
19,333,02232,SUB-DISTRICT,Bhagawangola - II,56,158024,80699,77325
19,333,02233,SUB-DISTRICT,Raninagar - II,30,190885,97359,93526
19,333,02234,SUB-DISTRICT,Jalangi,39,252477,129430,123047
19,333,02235,SUB-DISTRICT,Domkal,77,363976,186182,177794
19,333,02236,SUB-DISTRICT,Raninagar - I,57,164675,83846,80829
19,333,02237,SUB-DISTRICT,Murshidabad Jiaganj,127,234565,121187,113378
19,333,02238,SUB-DISTRICT,Nabagram,109,227586,116134,111452
19,333,02239,SUB-DISTRICT,Khargram,138,273332,139533,133799
19,333,02240,SUB-DISTRICT,Kandi,84,220145,112789,107356
19,333,02241,SUB-DISTRICT,Berhampore,124,337623,173129,164494
19,333,02242,SUB-DISTRICT,Hariharpara,55,257571,131634,125937
19,333,02243,SUB-DISTRICT,Nawda,28,226859,116341,110518
19,333,02244,SUB-DISTRICT,Beldanga - I,55,310470,159626,150844
19,333,02245,SUB-DISTRICT,Beldanga - II,61,250458,129144,121314
19,333,02246,SUB-DISTRICT,Bharatpur - II,51,153474,78380,75094
19,333,02247,SUB-DISTRICT,Bharatpur - I,82,172702,89088,83614
19,333,02248,SUB-DISTRICT,Burwan,155,257466,132439,125027
19,334,00000,DISTRICT,Birbhum,2242,3052956,1561976,1490980
19,334,02249,SUB-DISTRICT,Murarai - I,76,167941,85841,82100
19,334,02250,SUB-DISTRICT,Murarai - II,66,212237,107882,104355
19,334,02251,SUB-DISTRICT,Nalhati - I,89,204818,105070,99748
19,334,02252,SUB-DISTRICT,Nalhati - II,48,127785,65120,62665
19,334,02253,SUB-DISTRICT,Rampurhat - I,116,188435,95977,92458
19,334,02254,SUB-DISTRICT,Rampurhat - II,91,179705,92398,87307
19,334,02255,SUB-DISTRICT,Mayureswar - I,107,149606,76272,73334
19,334,02256,SUB-DISTRICT,Mayureswar - II,125,127661,65373,62288
19,334,02257,SUB-DISTRICT,Mohammad Bazar,138,164570,83590,80980
19,334,02258,SUB-DISTRICT,Rajnagar,88,64014,32632,31382
19,334,02259,SUB-DISTRICT,Suri - I,104,96141,49093,47048
19,334,02260,SUB-DISTRICT,Suri - II,85,87405,44921,42484
19,334,02261,SUB-DISTRICT,Sainthia,216,186107,95444,90663
19,334,02262,SUB-DISTRICT,Labpur,160,196482,101015,95467
19,334,02263,SUB-DISTRICT,Nanoor,130,213387,109495,103892
19,334,02264,SUB-DISTRICT,Bolpur Sriniketan,156,190393,96723,93670
19,334,02265,SUB-DISTRICT,Illambazar,127,161584,83056,78528
19,334,02266,SUB-DISTRICT,Dubrajpur,191,181437,92956,88481
19,334,02267,SUB-DISTRICT,Khoyrasol,130,153248,79118,74130
19,335,00000,DISTRICT,Barddhaman ,2418,4639264,2373787,2265477
19,335,02268,SUB-DISTRICT,Salanpur,69,101360,52152,49208
19,335,02269,SUB-DISTRICT,Barabani,46,79255,41042,38213
19,335,02270,SUB-DISTRICT,Jamuria,38,75144,39223,35921
19,335,02271,SUB-DISTRICT,Raniganj,12,23023,12010,11013
19,335,02272,SUB-DISTRICT,Ondal,12,35611,18956,16655
19,335,02273,SUB-DISTRICT,Pandabeswar,14,26720,13810,12910
19,335,02274,SUB-DISTRICT,Faridpur Durgapur,48,85370,44308,41062
19,335,02275,SUB-DISTRICT,Kanksa,77,103594,53213,50381
19,335,02276,SUB-DISTRICT,Ausgram - II,102,150896,77184,73712
19,335,02277,SUB-DISTRICT,Ausgram - I,58,119363,60521,58842
19,335,02278,SUB-DISTRICT,Mangolkote,130,263240,134693,128547
19,335,02279,SUB-DISTRICT,Ketugram - I,62,165408,84966,80442
19,335,02280,SUB-DISTRICT,Ketugram - II,55,118567,61413,57154
19,335,02281,SUB-DISTRICT,Katwa - I,63,166614,85733,80881
19,335,02282,SUB-DISTRICT,Katwa - II,63,136708,70588,66120
19,335,02283,SUB-DISTRICT,Purbasthali - I,91,153703,79462,74241
19,335,02284,SUB-DISTRICT,Purbasthali - II,88,212355,109442,102913
19,335,02285,SUB-DISTRICT,Manteswar,136,237398,120940,116458
19,335,02286,SUB-DISTRICT,Bhatar,104,263064,134096,128968
19,335,02287,SUB-DISTRICT,Galsi - I,85,164467,84915,79552
19,335,02288,SUB-DISTRICT,Galsi - II,73,147177,74751,72426
19,335,02289,SUB-DISTRICT,Burdwan - I,75,175836,89471,86365
19,335,02290,SUB-DISTRICT,Burdwan - II,83,146592,74013,72579
19,335,02291,SUB-DISTRICT,Memari - I,111,214005,108465,105540
19,335,02292,SUB-DISTRICT,Memari - II,88,150252,76500,73752
19,335,02293,SUB-DISTRICT,Kalna - I,98,186138,94925,91213
19,335,02294,SUB-DISTRICT,Kalna - II,112,157235,79440,77795
19,335,02295,SUB-DISTRICT,Jamalpur,121,266338,134529,131809
19,335,02296,SUB-DISTRICT,Raina - I,110,173094,88396,84698
19,335,02297,SUB-DISTRICT,Khandaghosh,107,189336,97092,92244
19,335,02298,SUB-DISTRICT,Raina - II,87,151401,77538,73863
19,336,00000,DISTRICT,Nadia ,1216,3728727,1921112,1807615
19,336,02299,SUB-DISTRICT,Karimpur - I,65,160895,83014,77881
19,336,02300,SUB-DISTRICT,Karimpur - II,65,217136,111488,105648
19,336,02301,SUB-DISTRICT,Tehatta - I,55,244322,125875,118447
19,336,02302,SUB-DISTRICT,Tehatta - II,32,151231,77299,73932
19,336,02303,SUB-DISTRICT,Kaliganj,105,306197,157234,148963
19,336,02304,SUB-DISTRICT,Nakashipara,101,352191,180990,171201
19,336,02305,SUB-DISTRICT,Chapra,77,296529,152575,143954
19,336,02306,SUB-DISTRICT,Krishnagar - II,44,134032,68826,65206
19,336,02307,SUB-DISTRICT, Nabadwip,21,76241,39515,36726
19,336,02308,SUB-DISTRICT,Krishnagar - I,87,285885,147239,138646
19,336,02309,SUB-DISTRICT,Krishnaganj,52,146705,75573,71132
19,336,02310,SUB-DISTRICT,Hanskhali,76,245899,127576,118323
19,336,02311,SUB-DISTRICT,Santipur,54,154256,79482,74774
19,336,02312,SUB-DISTRICT,Ranaghat - I,55,120847,62661,58186
19,336,02313,SUB-DISTRICT,Ranaghat - II,108,314519,162237,152282
19,336,02314,SUB-DISTRICT,Chakdah,137,314383,162899,151484
19,336,02315,SUB-DISTRICT,Haringhata,82,207459,106629,100830
19,337,00000,DISTRICT,North Twenty Four Parganas,1518,4277619,2196554,2081065
19,337,02316,SUB-DISTRICT,Bagda,106,242974,125270,117704
19,337,02317,SUB-DISTRICT,Bongaon,149,380903,196487,184416
19,337,02318,SUB-DISTRICT,Gaighata,100,265526,136500,129026
19,337,02319,SUB-DISTRICT,Swarupnagar,65,251715,129255,122460
19,337,02320,SUB-DISTRICT,Habra - I,55,175651,90735,84916
19,337,02321,SUB-DISTRICT,Habra - II,76,140675,72210,68465
19,337,02322,SUB-DISTRICT,Amdanga,79,185014,95215,89799
19,337,02323,SUB-DISTRICT,Barrackpur - I,38,94278,48354,45924
19,337,02324,SUB-DISTRICT,Barrackpur - II,15,51874,26701,25173
19,337,02325,SUB-DISTRICT,Barasat - I,70,175226,90238,84988
19,337,02326,SUB-DISTRICT,Barasat - II,76,188924,98235,90689
19,337,02327,SUB-DISTRICT,Deganga,107,309550,158216,151334
19,337,02328,SUB-DISTRICT,Baduria,96,278044,141944,136100
19,337,02329,SUB-DISTRICT,Basirhat - I,59,150520,76930,73590
19,337,02330,SUB-DISTRICT,Basirhat - II,66,208840,106868,101972
19,337,02331,SUB-DISTRICT,Haroa,90,214401,111080,103321
19,337,02332,SUB-DISTRICT,Rajarhat,30,89607,46121,43486
19,337,02333,SUB-DISTRICT,Minakhan,73,191973,98141,93832
19,337,02334,SUB-DISTRICT,Sandeshkhali - I,30,164465,83925,80540
19,337,02335,SUB-DISTRICT,Sandeshkhali - II,24,160976,81921,79055
19,337,02336,SUB-DISTRICT,Hasnabad,73,197014,100795,96219
19,337,02337,SUB-DISTRICT,Hingalganj,42,159469,81413,78056
19,338,00000,DISTRICT,Hugli ,1842,3390646,1722945,1667701
19,338,02338,SUB-DISTRICT,Goghat - I,97,140030,71804,68226
19,338,02339,SUB-DISTRICT,Goghat - II,110,160585,82262,78323
19,338,02340,SUB-DISTRICT,Arambag,152,285207,146041,139166
19,338,02341,SUB-DISTRICT,Pursura,50,173437,88908,84529
19,338,02342,SUB-DISTRICT,Tarakeswar,89,179148,91534,87614
19,338,02343,SUB-DISTRICT,Dhaniakhali,214,320534,160789,159745
19,338,02344,SUB-DISTRICT,Pandua,153,265863,133824,132039
19,338,02345,SUB-DISTRICT,Balagarh,129,200810,102488,98322
19,338,02346,SUB-DISTRICT,Chinsurah - Magra,52,86792,44235,42557
19,338,02347,SUB-DISTRICT,Polba - Dadpur,193,263555,133678,129877
19,338,02348,SUB-DISTRICT,Haripal,152,256507,129407,127100
19,338,02349,SUB-DISTRICT,Singur,98,223951,113561,110390
19,338,02350,SUB-DISTRICT,Serampur Uttarpara,13,36389,18640,17749
19,338,02351,SUB-DISTRICT,Chanditala - I,47,104677,52612,52065
19,338,02352,SUB-DISTRICT,Chanditala - II,20,48894,24559,24335
19,338,02353,SUB-DISTRICT,Jangipara,128,205099,103912,101187
19,338,02354,SUB-DISTRICT,Khanakul - I,93,254434,130712,123722
19,338,02355,SUB-DISTRICT,Khanakul - II,52,184734,93979,90755
19,339,00000,DISTRICT,Bankura ,3585,3296901,1685777,1611124
19,339,02356,SUB-DISTRICT,Saltora,145,135980,69732,66248
19,339,02357,SUB-DISTRICT,Mejhia,72,86188,44575,41613
19,339,02358,SUB-DISTRICT,Gangajalghati,156,180974,93252,87722
19,339,02359,SUB-DISTRICT,Chhatna,277,189712,96797,92915
19,339,02360,SUB-DISTRICT,Indpur,198,156522,80556,75966
19,339,02361,SUB-DISTRICT,Bankura - I,137,107685,55079,52606
19,339,02362,SUB-DISTRICT,Bankura - II,144,140864,72302,68562
19,339,02363,SUB-DISTRICT,Barjora,182,176263,90624,85639
19,339,02364,SUB-DISTRICT,Sonamukhi,161,158697,81610,77087
19,339,02365,SUB-DISTRICT,Patrasayer,151,184070,93614,90456
19,339,02366,SUB-DISTRICT,Indus,129,169783,86697,83086
19,339,02367,SUB-DISTRICT,Kotulpur,165,180292,92114,88178
19,339,02368,SUB-DISTRICT,Jaypur,137,156920,80138,76782
19,339,02369,SUB-DISTRICT,Vishnupur,147,156822,79941,76881
19,339,02370,SUB-DISTRICT,Onda,271,252984,129248,123736
19,339,02371,SUB-DISTRICT,Taldangra,141,147893,74999,72894
19,339,02372,SUB-DISTRICT,Simlapal,191,135832,69315,66517
19,339,02373,SUB-DISTRICT,Khatra,146,104592,53702,50890
19,339,02374,SUB-DISTRICT,Hirbandh,116,83834,42917,40917
19,339,02375,SUB-DISTRICT,Ranibundh,169,119089,60290,58799
19,339,02376,SUB-DISTRICT,Raipur,197,165097,84107,80990
19,339,02377,SUB-DISTRICT,Sarenga,153,106808,54168,52640
19,340,00000,DISTRICT,Puruliya,2459,2556801,1304208,1252593
19,340,02378,SUB-DISTRICT,Jaipur,109,123090,63633,59457
19,340,02379,SUB-DISTRICT,Purulia - II,101,157862,80492,77370
19,340,02380,SUB-DISTRICT,Para,118,167997,86423,81574
19,340,02381,SUB-DISTRICT,Raghunathpur - II,90,107827,55463,52364
19,340,02382,SUB-DISTRICT,Raghunathpur - I,79,96488,49762,46726
19,340,02383,SUB-DISTRICT,Neturia,110,83137,42707,40430
19,340,02384,SUB-DISTRICT,Santuri,92,72586,36995,35591
19,340,02385,SUB-DISTRICT,Kashipur,198,174325,88738,85587
19,340,02386,SUB-DISTRICT,Hura,111,143575,72867,70708
19,340,02387,SUB-DISTRICT,Purulia - I,105,145494,74873,70621
19,340,02388,SUB-DISTRICT,Puncha,99,123855,62676,61179
19,340,02389,SUB-DISTRICT,Arsha,95,154736,78398,76338
19,340,02390,SUB-DISTRICT,Jhalda - I,131,127759,65247,62512
19,340,02391,SUB-DISTRICT,Jhalda - II,118,135814,69141,66673
19,340,02392,SUB-DISTRICT,Bagmundi,138,135579,69520,66059
19,340,02393,SUB-DISTRICT,Balarampur,89,113519,58314,55205
19,340,02394,SUB-DISTRICT,Barabazar,202,162508,82158,80350
19,340,02395,SUB-DISTRICT,Manbazar - I,219,144550,73172,71378
19,340,02396,SUB-DISTRICT,Manbazar - II,124,97164,48943,48221
19,340,02397,SUB-DISTRICT,Bundwan,131,88936,44686,44250
19,341,00000,DISTRICT,Haora ,644,1775885,909519,866366
19,341,02398,SUB-DISTRICT,Udaynarayanpur,75,190186,97735,92451
19,341,02399,SUB-DISTRICT,Amta - II,65,192298,98887,93411
19,341,02400,SUB-DISTRICT,Amta - I,72,161193,82709,78484
19,341,02401,SUB-DISTRICT,Jagatballavpur,66,186698,95602,91096
19,341,02402,SUB-DISTRICT,Domjur,31,74510,37416,37094
19,341,02403,SUB-DISTRICT,Bally Jagachha,2,9300,4734,4566
19,341,02404,SUB-DISTRICT,Sankrail,14,35195,18017,17178
19,341,02405,SUB-DISTRICT,Panchla,13,43087,22147,20940
19,341,02406,SUB-DISTRICT,Uluberia - II,23,80793,41288,39505
19,341,02407,SUB-DISTRICT,Uluberia - I,66,184781,94250,90531
19,341,02408,SUB-DISTRICT,Bagnan - I,40,140116,72270,67846
19,341,02409,SUB-DISTRICT,Bagnan - II,41,119033,61419,57614
19,341,02410,SUB-DISTRICT,Shyampur - I,63,183220,93192,90028
19,341,02411,SUB-DISTRICT,Shyampur - II,73,175475,89853,85622
19,342,00000,DISTRICT,Kolkata,0,0,0,0
19,343,00000,DISTRICT,South Twenty Four Parganas,1994,6074188,3109219,2964969
19,343,02412,SUB-DISTRICT,Thakurpukur Mahestola,33,90180,45717,44463
19,343,02413,SUB-DISTRICT,Budge Budge - I,13,29573,15040,14533
19,343,02414,SUB-DISTRICT,Budge Budge - II,61,135254,69117,66137
19,343,02415,SUB-DISTRICT,Bishnupur - I,84,204385,104530,99855
19,343,02416,SUB-DISTRICT,Bishnupur - II,52,138979,71223,67756
19,343,02417,SUB-DISTRICT,Sonarpur,65,175713,89706,86007
19,343,02418,SUB-DISTRICT,Bhangar - I,80,228528,117229,111299
19,343,02419,SUB-DISTRICT,Bhangar - II,60,246708,127195,119513
19,343,02420,SUB-DISTRICT,Canning - I,53,181508,92684,88824
19,343,02421,SUB-DISTRICT,Canning - II,61,241331,122787,118544
19,343,02422,SUB-DISTRICT,Baruipur,122,315807,161643,154164
19,343,02423,SUB-DISTRICT,Magrahat - II,78,218504,112441,106063
19,343,02424,SUB-DISTRICT,Magrahat - I,78,203837,104329,99508
19,343,02425,SUB-DISTRICT,Falta,129,226162,115725,110437
19,343,02426,SUB-DISTRICT,Diamond Harbour - I,67,135160,69031,66129
19,343,02427,SUB-DISTRICT,Diamond Harbour - II,89,185808,95134,90674
19,343,02428,SUB-DISTRICT,Kulpi,172,266645,136359,130286
19,343,02429,SUB-DISTRICT,Mandirbazar,110,188995,97208,91787
19,343,02430,SUB-DISTRICT,Mathurapur - I,91,169263,86713,82550
19,343,02431,SUB-DISTRICT,Jaynagar - I,65,216829,111367,105462
19,343,02432,SUB-DISTRICT,Jaynagar - II,47,239784,122545,117239
19,343,02433,SUB-DISTRICT,Kultali,43,229053,117562,111491
19,343,02434,SUB-DISTRICT,Basanti,64,330092,167832,162260
19,343,02435,SUB-DISTRICT,Gosaba,50,246598,125910,120688
19,343,02436,SUB-DISTRICT,Mathurapur - II,27,220839,113831,107008
19,343,02437,SUB-DISTRICT,Kakdwip,39,281963,144120,137843
19,343,02438,SUB-DISTRICT,Sagar,42,212037,109468,102569
19,343,02439,SUB-DISTRICT,Namkhana,34,182830,93351,89479
19,343,02440,SUB-DISTRICT,Patharpratima,87,331823,169422,162401
19,344,00000,DISTRICT,Paschim Medinipur,7600,5190771,2641721,2549050
19,344,02441,SUB-DISTRICT,Binpur - II,401,158798,79793,79005
19,344,02442,SUB-DISTRICT,Binpur - I,427,156153,78929,77224
19,344,02443,SUB-DISTRICT,Garbeta - II,264,148410,75165,73245
19,344,02444,SUB-DISTRICT,Garbeta - I,306,218239,111379,106860
19,344,02445,SUB-DISTRICT,Garbeta - III,188,148809,75562,73247
19,344,02446,SUB-DISTRICT,Chandrakona - I,126,136006,69820,66186
19,344,02447,SUB-DISTRICT,Chandrakona - II,122,123269,63180,60089
19,344,02448,SUB-DISTRICT,Ghatal,139,219555,113199,106356
19,344,02449,SUB-DISTRICT,Daspur - I,157,203987,103757,100230
19,344,02450,SUB-DISTRICT,Daspur - II,87,238529,121742,116787
19,344,02451,SUB-DISTRICT,Keshpur,570,339248,173504,165744
19,344,02452,SUB-DISTRICT,Salbani,411,188653,95195,93458
19,344,02453,SUB-DISTRICT,Midnapore,232,191705,97490,94215
19,344,02454,SUB-DISTRICT,Jhargram,489,170097,85970,84127
19,344,02455,SUB-DISTRICT,Jamboni,281,113197,57607,55590
19,344,02456,SUB-DISTRICT,Gopiballavpur - II,175,104996,53459,51537
19,344,02457,SUB-DISTRICT,Gopiballavpur - I,199,108254,55475,52779
19,344,02458,SUB-DISTRICT,Nayagram,294,142199,71537,70662
19,344,02459,SUB-DISTRICT,Sankrail,247,115418,58240,57178
19,344,02460,SUB-DISTRICT,Kharagpur - I,228,165961,84489,81472
19,344,02461,SUB-DISTRICT,Kharagpur - II,330,183440,92546,90894
19,344,02462,SUB-DISTRICT,Debra,460,274835,138824,136011
19,344,02463,SUB-DISTRICT,Pingla,175,194809,99988,94821
19,344,02464,SUB-DISTRICT,Sabang,226,270492,138924,131568
19,344,02465,SUB-DISTRICT,Narayangarh,466,293613,148779,144834
19,344,02466,SUB-DISTRICT,Keshiary,202,149260,75601,73659
19,344,02467,SUB-DISTRICT,Dantan - I,181,165921,84466,81455
19,344,02468,SUB-DISTRICT,Dantan - II,118,155017,79543,75474
19,344,02469,SUB-DISTRICT,Mohanpur,100,111901,57558,54343
19,345,00000,DISTRICT,Purba Medinipur,2929,4503161,2322562,2180599
19,345,02470,SUB-DISTRICT,Panskura ,225,283303,145563,137740
19,345,02471,SUB-DISTRICT,Kolaghat,106,239646,124283,115363
19,345,02472,SUB-DISTRICT,Tamluk,99,207064,106904,100160
19,345,02473,SUB-DISTRICT,Sahid Matangini,81,183987,95352,88635
19,345,02474,SUB-DISTRICT,Nanda Kumar,100,262998,135720,127278
19,345,02475,SUB-DISTRICT,Mahisadal,73,199613,103023,96590
19,345,02476,SUB-DISTRICT,Moyna,85,220330,114551,105779
19,345,02477,SUB-DISTRICT,Potashpur - I,136,166977,86280,80697
19,345,02478,SUB-DISTRICT,Potashpur - II,144,175056,90319,84737
19,345,02479,SUB-DISTRICT,Bhagawanpur - II,167,192162,99060,93102
19,345,02480,SUB-DISTRICT,Bhagawanpur - I,164,222677,115228,107449
19,345,02481,SUB-DISTRICT,Chandipur,111,176704,91342,85362
19,345,02482,SUB-DISTRICT,Sutahata,78,118629,60892,57737
19,345,02483,SUB-DISTRICT,Haldia,24,97992,50531,47461
19,345,02484,SUB-DISTRICT,Nandigram - I,98,202032,103880,98152
19,345,02485,SUB-DISTRICT,Nandigram - II,40,117945,60601,57344
19,345,02486,SUB-DISTRICT,Khejuri - I,42,132992,68494,64498
19,345,02487,SUB-DISTRICT,Khejuri - II,97,139463,71294,68169
19,345,02488,SUB-DISTRICT,Contai - I,221,170894,88105,82789
19,345,02489,SUB-DISTRICT,Deshopran,166,170938,88094,82844
19,345,02490,SUB-DISTRICT,Contai - III,166,157793,81143,76650
19,345,02491,SUB-DISTRICT,Egra - I,123,167163,86458,80705
19,345,02492,SUB-DISTRICT,Egra - II,115,178763,92578,86185
19,345,02493,SUB-DISTRICT,Ramnagar - I,137,161986,82494,79492
19,345,02494,SUB-DISTRICT,Ramnagar - II,134,156054,80373,75681
20,000,00000,STATE,JHARKHAND,29492,25055073,12776486,12278587
20,346,00000,DISTRICT,Garhwa ,844,1253114,646947,606167
20,346,02495,SUB-DISTRICT,Kharaundhi,20,51479,26498,24981
20,346,02496,SUB-DISTRICT,Bhawnathpur,27,80057,41872,38185
20,346,02497,SUB-DISTRICT,Ketar,31,50821,26518,24303
20,346,02498,SUB-DISTRICT,Kandi,76,81521,42541,38980
20,346,02499,SUB-DISTRICT,Majhiaon,42,52586,27426,25160
20,346,02500,SUB-DISTRICT,Bardiha,22,37930,19527,18403
20,346,02501,SUB-DISTRICT,Ramna,38,70584,36556,34028
20,346,02502,SUB-DISTRICT,Bishunpura,29,32242,16669,15573
20,346,02503,SUB-DISTRICT,Nagaruntari,74,102772,53246,49526
20,346,02504,SUB-DISTRICT,Dhurki,28,55469,28544,26925
20,346,02505,SUB-DISTRICT,Sagma,16,30396,15798,14598
20,346,02506,SUB-DISTRICT,Dandai,28,63665,32558,31107
20,346,02507,SUB-DISTRICT,Chinia,30,38833,19761,19072
20,346,02508,SUB-DISTRICT,Meral (Pipra Kalan),75,130308,67253,63055
20,346,02509,SUB-DISTRICT,Garhwa,116,155568,81122,74446
20,346,02510,SUB-DISTRICT,Danda,7,17856,9195,8661
20,346,02511,SUB-DISTRICT,Ranka,78,90483,45783,44700
20,346,02512,SUB-DISTRICT,Ramkanda,32,44452,22525,21927
20,346,02513,SUB-DISTRICT,Bhandaria,75,66092,33555,32537
20,347,00000,DISTRICT,Chatra,1377,979932,500211,479721
20,347,02514,SUB-DISTRICT,Shaligram Ram Narayanpur(Hunterganj),250,187590,96328,91262
20,347,02515,SUB-DISTRICT,Pratappur,171,120221,61780,58441
20,347,02516,SUB-DISTRICT,Kunda,76,30018,15427,14591
20,347,02517,SUB-DISTRICT,Lawalaung,97,50553,25651,24902
20,347,02518,SUB-DISTRICT,Chatra,167,101014,51958,49056
20,347,02519,SUB-DISTRICT,Kanha Chatti,117,63012,32112,30900
20,347,02520,SUB-DISTRICT,Itkhori,137,74929,37869,37060
20,347,02521,SUB-DISTRICT,Mayur Hand,108,58925,29482,29443
20,347,02522,SUB-DISTRICT,Gidhaur,38,40919,20910,20009
20,347,02523,SUB-DISTRICT,Pathalgora,30,31530,15867,15663
20,347,02524,SUB-DISTRICT,Simaria,95,107871,54855,53016
20,347,02525,SUB-DISTRICT,Tandwa,91,113350,57972,55378
20,348,00000,DISTRICT,Kodarma,577,575013,293595,281418
20,348,02526,SUB-DISTRICT,Satgawan,113,74520,38183,36337
20,348,02527,SUB-DISTRICT,Kodarma,76,80303,40963,39340
20,348,02528,SUB-DISTRICT,Domchanch,101,109578,55915,53663
20,348,02529,SUB-DISTRICT,Jainagar,112,131279,67708,63571
20,348,02530,SUB-DISTRICT,Chandwara,75,84914,43961,40953
20,348,02531,SUB-DISTRICT,Markacho,100,94419,46865,47554
20,349,00000,DISTRICT,Giridih,2558,2237450,1149608,1087842
20,349,02532,SUB-DISTRICT,Gawan,137,115962,59039,56923
20,349,02533,SUB-DISTRICT,Tisri,183,95081,47423,47658
20,349,02534,SUB-DISTRICT,Deori,269,182527,94686,87841
20,349,02535,SUB-DISTRICT,Dhanwar,279,258575,133849,124726
20,349,02536,SUB-DISTRICT,Jamua,305,271563,139892,131671
20,349,02537,SUB-DISTRICT,Bengabad,231,153198,79018,74180
20,349,02538,SUB-DISTRICT,Gande,266,175087,90407,84680
20,349,02539,SUB-DISTRICT,Giridih,211,208260,107643,100617
20,349,02540,SUB-DISTRICT,Birni,172,169451,85970,83481
20,349,02541,SUB-DISTRICT,Bagodar,63,158094,80722,77372
20,349,02542,SUB-DISTRICT,Sariya,67,130135,66982,63153
20,349,02543,SUB-DISTRICT,Dumri,181,210002,108060,101942
20,349,02544,SUB-DISTRICT,Pirtanr,194,109515,55917,53598
20,350,00000,DISTRICT,Deoghar,2354,1233712,638136,595576
20,350,02545,SUB-DISTRICT,Deoghar,266,142966,74598,68368
20,350,02546,SUB-DISTRICT,Mohanpur,383,175845,91477,84368
20,350,02547,SUB-DISTRICT,Sarwan,203,90757,47269,43488
20,350,02548,SUB-DISTRICT,Sona Rai Tharhi,196,76116,39394,36722
20,350,02549,SUB-DISTRICT,Devipur,223,107015,55679,51336
20,350,02550,SUB-DISTRICT,Madhupur,206,135510,69827,65683
20,350,02551,SUB-DISTRICT,Margo Munda,119,86733,44284,42449
20,350,02552,SUB-DISTRICT,Karon,141,88251,45317,42934
20,350,02553,SUB-DISTRICT,Sarath,349,169238,87698,81540
20,350,02554,SUB-DISTRICT,Palojori,268,161281,82593,78688
20,351,00000,DISTRICT,Godda,1688,1249132,643907,605225
20,351,02555,SUB-DISTRICT,Meherma,144,146325,76588,69737
20,351,02556,SUB-DISTRICT,Thakurgangti,146,99603,51822,47781
20,351,02557,SUB-DISTRICT,Boarijor,309,138330,70106,68224
20,351,02558,SUB-DISTRICT,Mahagama,245,186007,96216,89791
20,351,02559,SUB-DISTRICT,Pathargama,146,115662,59780,55882
20,351,02560,SUB-DISTRICT,Bashant Rai,83,93448,48317,45131
20,351,02561,SUB-DISTRICT,Godda,197,216805,112369,104436
20,351,02562,SUB-DISTRICT,Poreyahat,197,187489,95814,91675
20,351,02563,SUB-DISTRICT,Sundarpahari,221,65463,32895,32568
20,352,00000,DISTRICT,Sahibganj,1349,990901,505892,485009
20,352,02564,SUB-DISTRICT,Sahibganj,21,73906,39275,34631
20,352,02565,SUB-DISTRICT,Mandro,184,75659,38114,37545
20,352,02566,SUB-DISTRICT,Borio,268,90881,45622,45259
20,352,02567,SUB-DISTRICT,Barhait,199,115742,58922,56820
20,352,02568,SUB-DISTRICT,Taljhari,205,76330,38659,37671
20,352,02569,SUB-DISTRICT,Rajmahal,101,140563,72364,68199
20,352,02570,SUB-DISTRICT,Udhwa,76,167727,86122,81605
20,352,02571,SUB-DISTRICT,Pathna,133,81940,41136,40804
20,352,02572,SUB-DISTRICT,Barharwa,162,168153,85678,82475
20,353,00000,DISTRICT,Pakur,1141,832910,418251,414659
20,353,02573,SUB-DISTRICT,Litipara,275,105701,52850,52851
20,353,02574,SUB-DISTRICT,Amrapara,121,65289,32923,32366
20,353,02575,SUB-DISTRICT,Hiranpur,119,84079,42506,41573
20,353,02576,SUB-DISTRICT,Pakaur,156,260403,130807,129596
20,353,02577,SUB-DISTRICT,Maheshpur,322,208862,104984,103878
20,353,02578,SUB-DISTRICT,Pakuria,148,108576,54181,54395
20,354,00000,DISTRICT,Dhanbad,1075,1124093,581956,542137
20,354,02579,SUB-DISTRICT,Tundi,190,102022,52181,49841
20,354,02580,SUB-DISTRICT,Purbi Tundi,79,50240,25634,24606
20,354,02581,SUB-DISTRICT,Topchanchi,105,111982,58207,53775
20,354,02582,SUB-DISTRICT,Baghmara-Cum-Katras,178,222657,116376,106281
20,354,02583,SUB-DISTRICT,Gobindpur ,213,220384,114021,106363
20,354,02584,SUB-DISTRICT,Dhanbad-Cum-Kenduadih-Cum-Jagata,26,33421,17406,16015
20,354,02586,SUB-DISTRICT,Baliapur ,63,121494,63158,58336
20,354,02587,SUB-DISTRICT,Nirsa-Cum-Chirkunda,221,261893,134973,126920
20,355,00000,DISTRICT,Bokaro,611,1078686,554954,523732
20,355,02588,SUB-DISTRICT,Nawadih,67,133848,67973,65875
20,355,02589,SUB-DISTRICT,Chandrapura,20,48776,25299,23477
20,355,02590,SUB-DISTRICT,Bermo,3,4222,2128,2094
20,355,02591,SUB-DISTRICT,Gumia,107,130898,66663,64235
20,355,02592,SUB-DISTRICT,Peterwar,62,127617,65604,62013
20,355,02593,SUB-DISTRICT,Kasmar,66,89974,45947,44027
20,355,02594,SUB-DISTRICT,Jaridih,38,75671,38937,36734
20,355,02595,SUB-DISTRICT,Chas,126,249083,128973,120110
20,355,02596,SUB-DISTRICT,Chandankiyari,122,218597,113430,105167
20,356,00000,DISTRICT,Lohardaga,352,404379,203255,201124
20,356,02597,SUB-DISTRICT,Kisko,52,54959,27692,27267
20,356,02598,SUB-DISTRICT,Peshrar,73,31057,15764,15293
20,356,02599,SUB-DISTRICT,Kuru,65,84827,42480,42347
20,356,02600,SUB-DISTRICT,Kairo,26,37867,18773,19094
20,356,02601,SUB-DISTRICT,Lohardaga,38,68598,34484,34114
20,356,02602,SUB-DISTRICT,Senha,53,69768,35308,34460
20,356,02603,SUB-DISTRICT,Bhandra,45,57303,28754,28549
20,357,00000,DISTRICT,Purbi Singhbhum,1609,1019328,514498,504830
20,357,02604,SUB-DISTRICT,Patamda,84,82876,41751,41125
20,357,02605,SUB-DISTRICT,Boram,73,69013,35142,33871
20,357,02606,SUB-DISTRICT,Golmuri-Cum-Jugsalai,83,102623,52218,50405
20,357,02607,SUB-DISTRICT,Ghatshila,152,89281,45006,44275
20,357,02608,SUB-DISTRICT,Potka,283,189127,94601,94526
20,357,02609,SUB-DISTRICT,Musabani,43,57486,28662,28824
20,357,02610,SUB-DISTRICT,Dumaria,90,62128,31043,31085
20,357,02611,SUB-DISTRICT,Dhalbhumgarh,103,61932,31309,30623
20,357,02612,SUB-DISTRICT,Gurbandha,82,43001,21703,21298
20,357,02613,SUB-DISTRICT,Chakulia,257,108810,54960,53850
20,357,02614,SUB-DISTRICT,Baharagora,359,153051,78103,74948
20,358,00000,DISTRICT,Palamu,1711,1713866,887551,826315
20,358,02615,SUB-DISTRICT,Hussainabad,153,133049,68748,64301
20,358,02616,SUB-DISTRICT,Haidernagar,51,74031,38629,35402
20,358,02617,SUB-DISTRICT,Mohammad Ganj,42,47315,24627,22688
20,358,02618,SUB-DISTRICT,Hariharganj,80,62392,32436,29956
20,358,02619,SUB-DISTRICT,Pipra,63,36389,18793,17596
20,358,02620,SUB-DISTRICT,Chhatarpur,130,147459,76944,70515
20,358,02621,SUB-DISTRICT,Nawadiha Bazar/Nawadiha,91,73799,38292,35507
20,358,02622,SUB-DISTRICT,Pandu,51,67886,35430,32456
20,358,02623,SUB-DISTRICT,Untari Road,26,38888,20400,18488
20,358,02624,SUB-DISTRICT,Bishrampur,57,62058,32160,29898
20,358,02625,SUB-DISTRICT,Nawa Bazar,46,50345,26261,24084
20,358,02626,SUB-DISTRICT,Patan,140,134536,70055,64481
20,358,02627,SUB-DISTRICT,Padwa,34,46957,24330,22627
20,358,02628,SUB-DISTRICT,Manatu,77,46856,24394,22462
20,358,02629,SUB-DISTRICT,Tarhasi,96,81297,41897,39400
20,358,02630,SUB-DISTRICT,Panki,183,157850,80749,77101
20,358,02631,SUB-DISTRICT,Satbarwa,56,66417,33882,32535
20,358,02632,SUB-DISTRICT,Nilambar-Pitambarpur(Lesliganj),115,100222,51940,48282
20,358,02633,SUB-DISTRICT,Medininagar(Daltonganj),51,81271,42227,39044
20,358,02634,SUB-DISTRICT,Chainpur,169,204849,105357,99492
20,359,00000,DISTRICT,Latehar,749,675120,342566,332554
20,359,02635,SUB-DISTRICT,Manika,82,88095,44923,43172
20,359,02636,SUB-DISTRICT,Barwadih,81,91104,46396,44708
20,359,02637,SUB-DISTRICT,Mahuadanr,101,74732,37915,36817
20,359,02638,SUB-DISTRICT,Garu,69,30274,15227,15047
20,359,02639,SUB-DISTRICT,Latehar,161,117514,59281,58233
20,359,02640,SUB-DISTRICT,Balumath,66,89012,45313,43699
20,359,02641,SUB-DISTRICT,Bariyatu,56,60095,30359,29736
20,359,02642,SUB-DISTRICT,Herhanj,50,34630,17772,16858
20,359,02643,SUB-DISTRICT,Chandwa,83,89664,45380,44284
20,360,00000,DISTRICT,Hazaribagh,1193,1459188,746934,712254
20,360,02644,SUB-DISTRICT,Chauparan,233,156453,78294,78159
20,360,02645,SUB-DISTRICT,Barhi,100,111544,57496,54048
20,360,02646,SUB-DISTRICT,Padma,40,56014,28941,27073
20,360,02647,SUB-DISTRICT,Ichak,88,112815,58244,54571
20,360,02648,SUB-DISTRICT,Tati Jhariya,53,48549,24061,24488
20,360,02649,SUB-DISTRICT,Daru,52,52305,27022,25283
20,360,02650,SUB-DISTRICT,Barkatha,81,122269,62849,59420
20,360,02651,SUB-DISTRICT,Chalkusa,36,52068,26952,25116
20,360,02652,SUB-DISTRICT,Bishungarh,89,146351,73703,72648
20,360,02653,SUB-DISTRICT,Hazaribag,80,118276,62156,56120
20,360,02654,SUB-DISTRICT,Katkamsandi,77,93513,47712,45801
20,360,02655,SUB-DISTRICT,Katamdag,46,69150,35642,33508
20,360,02656,SUB-DISTRICT,Keredari,72,91357,46827,44530
20,360,02657,SUB-DISTRICT,Barkagaon,82,131891,67718,64173
20,360,02658,SUB-DISTRICT,Churchu,40,46863,23847,23016
20,360,02659,SUB-DISTRICT,Dadi,24,49770,25470,24300
20,361,00000,DISTRICT,Ramgarh,305,530488,272167,258321
20,361,02660,SUB-DISTRICT,Patratu,67,92822,47629,45193
20,361,02661,SUB-DISTRICT,Mandu,70,133757,68697,65060
20,361,02662,SUB-DISTRICT,Ramgarh,20,47871,24514,23357
20,361,02663,SUB-DISTRICT,Dulmi,40,66238,33993,32245
20,361,02664,SUB-DISTRICT,Chitarpur,20,39990,20569,19421
20,361,02665,SUB-DISTRICT,Gola,88,149810,76765,73045
20,362,00000,DISTRICT,Dumka,2688,1231264,620928,610336
20,362,02666,SUB-DISTRICT,Saraiyahat,285,156291,80535,75756
20,362,02667,SUB-DISTRICT,Jarmundi,470,168163,85341,82822
20,362,02668,SUB-DISTRICT,Ramgarh,322,159911,79944,79967
20,362,02669,SUB-DISTRICT,Gopikandar,128,42063,20999,21064
20,362,02670,SUB-DISTRICT,Kathikund,193,71458,35598,35860
20,362,02671,SUB-DISTRICT,Shikaripara,242,131464,65723,65741
20,362,02672,SUB-DISTRICT,Ranishwar,191,101667,51115,50552
20,362,02673,SUB-DISTRICT,Dumka,256,137730,69224,68506
20,362,02674,SUB-DISTRICT,Jama,311,137963,69621,68342
20,362,02675,SUB-DISTRICT,Masalia,290,124554,62828,61726
20,363,00000,DISTRICT,Jamtara,1082,715296,365043,350253
20,363,02676,SUB-DISTRICT,Narayanpur,247,163966,83977,79989
20,363,02677,SUB-DISTRICT,Karma Tanr Vidyasagar,145,109398,55923,53475
20,363,02678,SUB-DISTRICT,Jamtara,124,132600,67389,65211
20,363,02679,SUB-DISTRICT,Nala,242,134780,68771,66009
20,363,02680,SUB-DISTRICT,Fatehpur,168,89645,45546,44099
20,363,02681,SUB-DISTRICT,Kundhit,156,84907,43437,41470
20,364,00000,DISTRICT,Ranchi,1296,1656918,840528,816390
20,364,02682,SUB-DISTRICT,Burmu,77,89889,45663,44226
20,364,02683,SUB-DISTRICT,Khelari,14,21869,11209,10660
20,364,02684,SUB-DISTRICT,Kanke,103,216930,111800,105130
20,364,02685,SUB-DISTRICT,Ormanjhi,87,88927,45670,43257
20,364,02686,SUB-DISTRICT,Angara,82,112759,56841,55918
20,364,02687,SUB-DISTRICT,Rahe,59,53916,27334,26582
20,364,02688,SUB-DISTRICT,Silli,94,101054,51498,49556
20,364,02689,SUB-DISTRICT,Sonahatu,64,77252,39127,38125
20,364,02690,SUB-DISTRICT,Namkum,92,118002,59330,58672
20,364,02691,SUB-DISTRICT,Ratu,37,54186,27264,26922
20,364,02692,SUB-DISTRICT,Nagri,44,65252,32905,32347
20,364,02693,SUB-DISTRICT,Mandar,69,128585,65134,63451
20,364,02694,SUB-DISTRICT,Chanho,67,107503,54283,53220
20,364,02695,SUB-DISTRICT,Bero,84,113090,57311,55779
20,364,02696,SUB-DISTRICT,Itki,30,50058,25234,24824
20,364,02697,SUB-DISTRICT,Lapung,78,63053,31319,31734
20,364,02698,SUB-DISTRICT,Bundu,87,61921,31533,30388
20,364,02699,SUB-DISTRICT,Tamar I,128,132672,67073,65599
20,365,00000,DISTRICT,Khunti,754,486903,243494,243409
20,365,02700,SUB-DISTRICT,Karra,178,109082,54615,54467
20,365,02701,SUB-DISTRICT,Torpa,94,84399,41997,42402
20,365,02702,SUB-DISTRICT,Rania,66,39349,19638,19711
20,365,02703,SUB-DISTRICT,Murhu,141,85486,42936,42550
20,365,02704,SUB-DISTRICT,Khunti,147,87998,43835,44163
20,365,02705,SUB-DISTRICT,Erki(Tamar II),128,80589,40473,40116
20,366,00000,DISTRICT,Gumla,942,960132,481135,478997
20,366,02706,SUB-DISTRICT,Bishunpur,68,62319,31506,30813
20,366,02707,SUB-DISTRICT,Ghaghra,119,105819,52853,52966
20,366,02708,SUB-DISTRICT,Sisai,87,116844,58427,58417
20,366,02709,SUB-DISTRICT,Verno,69,84572,42355,42217
20,366,02710,SUB-DISTRICT,Kamdara,73,63775,31686,32089
20,366,02711,SUB-DISTRICT,Basia,88,80731,40321,40410
20,366,02712,SUB-DISTRICT,Gumla,107,157119,78956,78163
20,366,02713,SUB-DISTRICT,Chainpur,83,56591,28397,28194
20,366,02714,SUB-DISTRICT,Dumri,63,49134,24885,24249
20,366,02715,SUB-DISTRICT,Albert Ekka(Jari),51,30926,15786,15140
20,366,02716,SUB-DISTRICT,Raidih,61,71443,35748,35695
20,366,02717,SUB-DISTRICT,Palkot,73,80859,40215,40644
20,367,00000,DISTRICT,Simdega,449,556634,278425,278209
20,367,02718,SUB-DISTRICT,Simdega,61,72131,36093,36038
20,367,02719,SUB-DISTRICT,Pakar Tanr,31,37507,19065,18442
20,367,02720,SUB-DISTRICT,Kurdeg,25,47984,23881,24103
20,367,02721,SUB-DISTRICT,Kersai,20,39218,19582,19636
20,367,02722,SUB-DISTRICT,Bolba,26,30786,15223,15563
20,367,02723,SUB-DISTRICT,Thethaitangar,61,87458,43710,43748
20,367,02724,SUB-DISTRICT,Kolebira,53,71283,35993,35290
20,367,02725,SUB-DISTRICT,Jaldega,60,64286,32167,32119
20,367,02726,SUB-DISTRICT,Bansjor,19,25519,12856,12663
20,367,02727,SUB-DISTRICT,Bano,93,80462,39855,40607
20,368,00000,DISTRICT,Pashchimi Singhbhum,1642,1284304,637657,646647
20,368,02728,SUB-DISTRICT,Sonua,100,77697,38612,39085
20,368,02729,SUB-DISTRICT,Gudri,88,38282,19445,18837
20,368,02730,SUB-DISTRICT,Bandgaon,214,87072,43497,43575
20,368,02731,SUB-DISTRICT,Chakradharpur,171,141422,70153,71269
20,368,02732,SUB-DISTRICT,Khuntpani,115,83047,41079,41968
20,368,02733,SUB-DISTRICT,Goilkera,106,74019,37167,36852
20,368,02734,SUB-DISTRICT,Anandpur,88,44406,22158,22248
20,368,02735,SUB-DISTRICT,Manoharpur,99,77689,39183,38506
20,368,02736,SUB-DISTRICT,Noamundi,62,58832,29573,29259
20,368,02737,SUB-DISTRICT,Tonto,73,59918,29794,30124
20,368,02738,SUB-DISTRICT,Hat Gamharia,54,67226,33414,33812
20,368,02739,SUB-DISTRICT,Chaibasa,74,86389,42327,44062
20,368,02740,SUB-DISTRICT,Tantnagar,76,63910,31480,32430
20,368,02741,SUB-DISTRICT,Manjhari,64,68450,33634,34816
20,368,02742,SUB-DISTRICT,Jhinkpani,27,40724,19858,20866
20,368,02743,SUB-DISTRICT,Jagannathpur,83,87253,43160,44093
20,368,02744,SUB-DISTRICT,Kumardungi,60,55352,27253,28099
20,368,02745,SUB-DISTRICT,Majhgaon,88,72616,35870,36746
20,369,00000,DISTRICT,Saraikela-Kharsawan,1146,806310,408848,397462
20,369,02746,SUB-DISTRICT,Kuchai,99,64320,32443,31877
20,369,02747,SUB-DISTRICT,Kharsawan,128,88642,45001,43641
20,369,02748,SUB-DISTRICT,Chandil,104,109854,56163,53691
20,369,02749,SUB-DISTRICT,Ichagarh,107,83099,42391,40708
20,369,02750,SUB-DISTRICT,Kukru,45,52976,27069,25907
20,369,02751,SUB-DISTRICT,Nimdih,62,78639,40327,38312
20,369,02752,SUB-DISTRICT,Adityapur(Gamharia),187,119055,60995,58060
20,369,02753,SUB-DISTRICT,Saraikela,168,73125,36649,36476
20,369,02754,SUB-DISTRICT,Gobindpur(Rajnagar),246,136600,67810,68790
21,000,00000,STATE,ODISHA,47675,34970562,17586203,17384359
21,370,00000,DISTRICT,Bargarh,1179,1331145,672603,658542
21,370,02755,SUB-DISTRICT,Paikamal,101,91916,45732,46184
21,370,02756,SUB-DISTRICT,Jharbandha,104,103676,51217,52459
21,370,02757,SUB-DISTRICT,Padmapur,71,63634,31873,31761
21,370,02758,SUB-DISTRICT,Burden,52,33259,16441,16818
21,370,02759,SUB-DISTRICT,Gaisilet,83,77443,38755,38688
21,370,02760,SUB-DISTRICT,Melchhamunda,73,70239,35255,34984
21,370,02761,SUB-DISTRICT,Sohela,92,97649,49414,48235
21,370,02762,SUB-DISTRICT,Bijepur,108,100452,50680,49772
21,370,02763,SUB-DISTRICT,Barapali,73,107421,55025,52396
21,370,02764,SUB-DISTRICT,Bheden,97,127400,65064,62336
21,370,02765,SUB-DISTRICT,Bargarh,20,71200,36892,34308
21,370,02766,SUB-DISTRICT,Bargarh Sadar ,40,78389,40097,38292
21,370,02767,SUB-DISTRICT,Bhatli,83,85456,43117,42339
21,370,02768,SUB-DISTRICT,Ambabhona,104,65715,33096,32619
21,370,02769,SUB-DISTRICT,Attabira,78,157296,79945,77351
21,371,00000,DISTRICT,Jharsuguda,347,348340,176162,172178
21,371,02770,SUB-DISTRICT,Rengali,76,60136,30461,29675
21,371,02771,SUB-DISTRICT,Lakhanpur,33,34228,17173,17055
21,371,02772,SUB-DISTRICT,Belpahar,4,3644,1799,1845
21,371,02773,SUB-DISTRICT,Banaharapali,30,34304,17472,16832
21,371,02774,SUB-DISTRICT,Orient,1,303,168,135
21,371,02775,SUB-DISTRICT,Brajarajnagar,32,22180,11220,10960
21,371,02776,SUB-DISTRICT,Jharsuguda,16,25087,12702,12385
21,371,02777,SUB-DISTRICT,Badmal ,23,27566,14687,12879
21,371,02778,SUB-DISTRICT,Laikera,91,99157,49588,49569
21,371,02779,SUB-DISTRICT,Kolabira,41,41735,20892,20843
21,372,00000,DISTRICT,Sambalpur,1229,733006,368692,364314
21,372,02780,SUB-DISTRICT,Govindpur,66,59141,29416,29725
21,372,02781,SUB-DISTRICT,Mahulpalli,143,76632,38019,38613
21,372,02782,SUB-DISTRICT,Kochinda,144,66092,32971,33121
21,372,02783,SUB-DISTRICT,Katarbaga,31,29875,14975,14900
21,372,02784,SUB-DISTRICT,Thelkoloi  ,14,26915,13788,13127
21,372,02785,SUB-DISTRICT,Rengali ,15,15992,8199,7793
21,372,02786,SUB-DISTRICT,Sasan,61,63790,32399,31391
21,372,02787,SUB-DISTRICT,Hirakud,3,7680,3868,3812
21,372,02788,SUB-DISTRICT,Burla,34,39116,19931,19185
21,372,02789,SUB-DISTRICT,Dhanupali,4,7727,3996,3731
21,372,02790,SUB-DISTRICT,Ainthapali,8,12627,6318,6309
21,372,02791,SUB-DISTRICT,Sadar,42,46660,23677,22983
21,372,02792,SUB-DISTRICT,Jamankira,148,59250,29528,29722
21,372,02793,SUB-DISTRICT,Kisinda,73,20460,10262,10198
21,372,02794,SUB-DISTRICT,Jujomura,89,57271,28942,28329
21,372,02795,SUB-DISTRICT,Dhama,67,44579,22651,21928
21,372,02796,SUB-DISTRICT,Charamal,98,29526,14876,14650
21,372,02797,SUB-DISTRICT,Rairakhol,122,40123,20126,19997
21,372,02798,SUB-DISTRICT,Naktideul,67,29550,14750,14800
21,372,02799,SUB-DISTRICT,Sambalpur (M),0,0,0,0
21,373,00000,DISTRICT,Debagarh,718,290130,146666,143464
21,373,02800,SUB-DISTRICT,Debagarh,202,85516,43043,42473
21,373,02801,SUB-DISTRICT,Barkot,154,72887,36965,35922
21,373,02802,SUB-DISTRICT,Kundheigola,135,52419,26921,25498
21,373,02803,SUB-DISTRICT,Reamal,227,79308,39737,39571
21,374,00000,DISTRICT,Sundargarh,1713,1355340,676068,679272
21,374,02804,SUB-DISTRICT,Hemgir,143,84559,42670,41889
21,374,02805,SUB-DISTRICT,Lephripara,106,70547,35375,35172
21,374,02806,SUB-DISTRICT,Bhasma,51,42101,21184,20917
21,374,02807,SUB-DISTRICT,Dharuadihi,45,35427,17687,17740
21,374,02808,SUB-DISTRICT,Sundargarh Town,2,3933,1999,1934
21,374,02809,SUB-DISTRICT,Sundargarh ,87,74134,36813,37321
21,374,02810,SUB-DISTRICT,Kinjirkela,59,57452,28444,29008
21,374,02811,SUB-DISTRICT,Talasara,86,80443,39684,40759
21,374,02812,SUB-DISTRICT,Baragaon,74,77943,38984,38959
21,374,02813,SUB-DISTRICT,Kutra,43,66462,33283,33179
21,374,02814,SUB-DISTRICT,Rajagangapur,78,102449,51081,51368
21,374,02815,SUB-DISTRICT,Raiboga,44,43474,21658,21816
21,374,02816,SUB-DISTRICT,Biramitrapur,61,54396,27190,27206
21,374,02817,SUB-DISTRICT,Hatibari,63,61931,30686,31245
21,374,02818,SUB-DISTRICT,Bisra,112,98455,49054,49401
21,374,02819,SUB-DISTRICT,Bondamunda,13,14399,7298,7101
21,374,02820,SUB-DISTRICT,Brahmani Tarang,48,57664,28736,28928
21,374,02821,SUB-DISTRICT,Raghunathapali,1,1368,681,687
21,374,02822,SUB-DISTRICT,Tangarapali,4,5851,2994,2857
21,374,02823,SUB-DISTRICT,Lathikata,28,17441,8913,8528
21,374,02824,SUB-DISTRICT,Chandiposh,41,21864,10903,10961
21,374,02825,SUB-DISTRICT,Kamarposh Balang,57,42854,21470,21384
21,374,02826,SUB-DISTRICT,Koida,52,34061,17090,16971
21,374,02827,SUB-DISTRICT,Lahunipara,154,73372,36364,37008
21,374,02828,SUB-DISTRICT,Gurundia,71,35256,17419,17837
21,374,02829,SUB-DISTRICT,Tikaetpali,45,23589,11655,11934
21,374,02830,SUB-DISTRICT,Banei,110,54724,26984,27740
21,374,02831,SUB-DISTRICT,Mahulapada,35,19191,9769,9422
21,374,02832,SUB-DISTRICT,Raurkela (M),0,0,0,0
21,374,02833,SUB-DISTRICT,Raurkela (ITS),0,0,0,0
21,375,00000,DISTRICT,Kendujhar,2064,1548674,774667,774007
21,375,02834,SUB-DISTRICT,Barbil,18,17590,8996,8594
21,375,02835,SUB-DISTRICT,Bolani,11,8285,4153,4132
21,375,02836,SUB-DISTRICT,Rugudi,17,16560,8807,7753
21,375,02837,SUB-DISTRICT,Joda,30,26067,13148,12919
21,375,02838,SUB-DISTRICT,Bamebari ,59,48789,24796,23993
21,375,02839,SUB-DISTRICT,Champua,114,86723,43213,43510
21,375,02840,SUB-DISTRICT,Jhumpura,53,40872,20394,20478
21,375,02841,SUB-DISTRICT,Baria,104,73664,36318,37346
21,375,02842,SUB-DISTRICT,Turumunga,105,68598,34045,34553
21,375,02843,SUB-DISTRICT,Patana,162,104824,51715,53109
21,375,02844,SUB-DISTRICT,Kendujhar Sadar,212,157414,78278,79136
21,375,02845,SUB-DISTRICT,Kendujhar Town,56,38290,19447,18843
21,375,02846,SUB-DISTRICT,Nayakote,70,46056,22647,23409
21,375,02847,SUB-DISTRICT,Kanjipani,38,21741,10745,10996
21,375,02848,SUB-DISTRICT,Telkoi,140,95718,47631,48087
21,375,02849,SUB-DISTRICT,Pandapara,94,63308,31628,31680
21,375,02850,SUB-DISTRICT,Ghatgaon,129,107106,53470,53636
21,375,02851,SUB-DISTRICT,Harichandanpur,108,80711,40443,40268
21,375,02852,SUB-DISTRICT,Daitari,42,23506,11784,11722
21,375,02853,SUB-DISTRICT,Ghasipura,105,112740,56821,55919
21,375,02854,SUB-DISTRICT,Anandapur,106,84633,42232,42401
21,375,02855,SUB-DISTRICT,Soso,76,64244,32264,31980
21,375,02856,SUB-DISTRICT,Nandipada,122,82542,41873,40669
21,375,02857,SUB-DISTRICT,Sainkul,93,78693,39819,38874
21,376,00000,DISTRICT,Mayurbhanj,3751,2326842,1157576,1169266
21,376,02858,SUB-DISTRICT,Tiring,129,100517,49836,50681
21,376,02859,SUB-DISTRICT,Bahalda,61,53231,26398,26833
21,376,02860,SUB-DISTRICT,Jamda,66,48811,23500,25311
21,376,02861,SUB-DISTRICT,Rairangpur Town,31,15869,7781,8088
21,376,02862,SUB-DISTRICT,Gorumahisani,127,47653,23186,24467
21,376,02863,SUB-DISTRICT,Jharpokharia,180,99794,50417,49377
21,376,02864,SUB-DISTRICT,Bisoi,145,73899,36029,37870
21,376,02865,SUB-DISTRICT,Rairangpur,116,81722,40324,41398
21,376,02866,SUB-DISTRICT,Badampahar,81,63890,31056,32834
21,376,02867,SUB-DISTRICT,Jashipur,250,115929,57045,58884
21,376,02868,SUB-DISTRICT,Raruan,112,78209,38739,39470
21,376,02869,SUB-DISTRICT,Ghagarbeda ,42,28900,14413,14487
21,376,02870,SUB-DISTRICT,Karanjia,154,91518,45310,46208
21,376,02871,SUB-DISTRICT,Thakurmunda,110,57890,28262,29628
21,376,02872,SUB-DISTRICT,Baripada Sadar,132,87091,43681,43410
21,376,02873,SUB-DISTRICT,Baripada Town,10,5149,2595,2554
21,376,02874,SUB-DISTRICT,Koliana,173,82810,41256,41554
21,376,02875,SUB-DISTRICT,Bangiriposi,211,104902,52367,52535
21,376,02876,SUB-DISTRICT,Chandua,118,63390,32191,31199
21,376,02877,SUB-DISTRICT,Suliapada,155,86355,43238,43117
21,376,02878,SUB-DISTRICT,Muruda,115,77337,38420,38917
21,376,02879,SUB-DISTRICT,Rasagobindapur,164,96526,48808,47718
21,376,02880,SUB-DISTRICT,Baisinga,198,122036,61341,60695
21,376,02881,SUB-DISTRICT,Betanati,120,89666,45159,44507
21,376,02882,SUB-DISTRICT,Barsahi,189,132580,66782,65798
21,376,02883,SUB-DISTRICT,Khunta,220,123616,61119,62497
21,376,02884,SUB-DISTRICT,Udala,122,96952,48238,48714
21,376,02885,SUB-DISTRICT,Kaptipada,99,76427,38507,37920
21,376,02886,SUB-DISTRICT,Sharata,59,77369,38620,38749
21,376,02887,SUB-DISTRICT,Mahuldiha,62,46804,22958,23846
21,376,02888,SUB-DISTRICT,Baripada (M),0,0,0,0
21,377,00000,DISTRICT,Baleshwar,2635,2067236,1056466,1010770
21,377,02889,SUB-DISTRICT,Raibania ,66,80472,40679,39793
21,377,02890,SUB-DISTRICT,Jaleswar ,144,123423,63679,59744
21,377,02891,SUB-DISTRICT,Bhograi,216,188559,97404,91155
21,377,02892,SUB-DISTRICT,Kamarda,104,96162,49832,46330
21,377,02893,SUB-DISTRICT,Baliapal ,167,169958,86865,83093
21,377,02894,SUB-DISTRICT,Singla ,138,134178,69087,65091
21,377,02895,SUB-DISTRICT,Basta ,249,151915,78160,73755
21,377,02896,SUB-DISTRICT,Rupsa ,28,25189,12835,12354
21,377,02897,SUB-DISTRICT,Baleshwar Sadar,236,179092,92071,87021
21,377,02898,SUB-DISTRICT,Sahadevkhunta,8,10233,5301,4932
21,377,02899,SUB-DISTRICT,Chandipur ,26,40588,20756,19832
21,377,02900,SUB-DISTRICT,Balaramgadi Marine ,3,5237,2669,2568
21,377,02901,SUB-DISTRICT,Bampada ,20,11287,5848,5439
21,377,02902,SUB-DISTRICT,Remuna ,103,58290,29610,28680
21,377,02903,SUB-DISTRICT,Nilagiri ,159,114904,58201,56703
21,377,02904,SUB-DISTRICT,Berhampur ,70,57614,28815,28799
21,377,02905,SUB-DISTRICT,Oupada  ,76,39759,19745,20014
21,377,02906,SUB-DISTRICT,Khaira  ,265,139777,69400,70377
21,377,02907,SUB-DISTRICT,Soro,324,278976,143693,135283
21,377,02908,SUB-DISTRICT,Similia ,233,161623,81816,79807
21,377,02909,SUB-DISTRICT,Baleshwar (M),0,0,0,0
21,378,00000,DISTRICT,Bhadrak,1250,1320499,665255,655244
21,378,02910,SUB-DISTRICT,Agarpada ,73,58238,29396,28842
21,378,02911,SUB-DISTRICT,Bant ,99,63463,32087,31376
21,378,02912,SUB-DISTRICT,Bhandari Pokhari ,137,110429,55370,55059
21,378,02913,SUB-DISTRICT,Dhamanagar,107,96465,48350,48115
21,378,02914,SUB-DISTRICT,Bhadrak Rural ,169,226211,115006,111205
21,378,02915,SUB-DISTRICT,Basudebpur ,92,127819,63356,64463
21,378,02916,SUB-DISTRICT,Naikanidihi ,82,91289,46286,45003
21,378,02917,SUB-DISTRICT,Tihidi ,153,195003,97672,97331
21,378,02918,SUB-DISTRICT,Dhusuri ,82,121894,61477,60417
21,378,02919,SUB-DISTRICT,Chandabali ,103,100905,50797,50108
21,378,02920,SUB-DISTRICT,Bansada ,150,124708,63352,61356
21,378,02921,SUB-DISTRICT,Dhamara Marine,3,4075,2106,1969
21,379,00000,DISTRICT,Kendrapara ,1415,1356827,675053,681774
21,379,02922,SUB-DISTRICT,Rajkanika ,156,140807,67443,73364
21,379,02923,SUB-DISTRICT,Rajnagar ,242,163450,82469,80981
21,379,02924,SUB-DISTRICT,Jamboo Marine  ,17,29491,15408,14083
21,379,02925,SUB-DISTRICT,Aali ,126,137800,64507,73293
21,379,02926,SUB-DISTRICT,Pattamundai ,153,182535,89008,93527
21,379,02927,SUB-DISTRICT,Kendrapara,0,0,0,0
21,379,02928,SUB-DISTRICT,Kendrapara Sadar  ,178,158985,80770,78215
21,379,02929,SUB-DISTRICT,Nikirai ,55,67946,33925,34021
21,379,02930,SUB-DISTRICT,Derabish ,91,65909,33589,32320
21,379,02931,SUB-DISTRICT,Patkura ,188,177324,90051,87273
21,379,02932,SUB-DISTRICT,Marsaghai ,78,108163,55305,52858
21,379,02933,SUB-DISTRICT,Mahakalapada ,131,124417,62578,61839
21,380,00000,DISTRICT,Jagatsinghapur ,1223,1020991,516813,504178
21,380,02934,SUB-DISTRICT,Paradip ,2,3052,1729,1323
21,380,02935,SUB-DISTRICT,Paradeep Lock ,24,34976,17893,17083
21,380,02936,SUB-DISTRICT,Kujang ,105,108944,55621,53323
21,380,02937,SUB-DISTRICT,Abhyachandpur  ,15,23588,12076,11512
21,380,02938,SUB-DISTRICT,Ersama ,150,106896,53557,53339
21,380,02939,SUB-DISTRICT,Tirtol ,305,206892,104140,102752
21,380,02940,SUB-DISTRICT,Jagatsinghapur,231,210939,106826,104113
21,380,02941,SUB-DISTRICT,Biridi,80,82795,42227,40568
21,380,02942,SUB-DISTRICT,Naugaon ,88,78016,39150,38866
21,380,02943,SUB-DISTRICT,Balikuda ,223,164893,83594,81299
21,381,00000,DISTRICT,Cuttack,1854,1888423,970885,917538
21,381,02944,SUB-DISTRICT,Narasinghpur ,157,97624,51055,46569
21,381,02945,SUB-DISTRICT,Kanpur ,69,59577,31413,28164
21,381,02946,SUB-DISTRICT,Badamba ,134,143509,75001,68508
21,381,02947,SUB-DISTRICT,Baidyeswar ,57,55250,28572,26678
21,381,02948,SUB-DISTRICT,Banki ,89,159046,82505,76541
21,381,02949,SUB-DISTRICT,Tigiria ,47,66582,34482,32100
21,381,02950,SUB-DISTRICT,Athagad ,91,71828,37033,34795
21,381,02951,SUB-DISTRICT,Barang ,22,32024,16776,15248
21,381,02952,SUB-DISTRICT,Gurudijhatia ,45,34081,17321,16760
21,381,02953,SUB-DISTRICT,Khuntuni  ,49,38761,19654,19107
21,381,02954,SUB-DISTRICT,Choudwar ,49,59880,30455,29425
21,381,02955,SUB-DISTRICT,Tangi ,95,74534,38254,36280
21,381,02956,SUB-DISTRICT,Mahanga ,193,186930,96119,90811
21,381,02957,SUB-DISTRICT,Salepur ,125,143416,72741,70675
21,381,02958,SUB-DISTRICT,Nischintakoili ,50,53498,27535,25963
21,381,02959,SUB-DISTRICT,Nemalo,97,69334,35004,34330
21,381,02960,SUB-DISTRICT,Kishannagar ,110,97616,49898,47718
21,381,02961,SUB-DISTRICT,Jagatpur ,37,62359,31975,30384
21,381,02962,SUB-DISTRICT,Cuttack Sadar ,97,108641,55381,53260
21,381,02963,SUB-DISTRICT,Kandarpur,27,33732,17218,16514
21,381,02964,SUB-DISTRICT,C.R.R.I. ,4,3190,1588,1602
21,381,02965,SUB-DISTRICT,Gobindpur ,65,63971,32659,31312
21,381,02966,SUB-DISTRICT,Olatapur,21,25543,13200,12343
21,381,02967,SUB-DISTRICT,Niali ,126,147497,75046,72451
21,381,02968,SUB-DISTRICT,Cuttack (M Corp.),0,0,0,0
21,382,00000,DISTRICT,Jajapur  ,1598,1692095,856539,835556
21,382,02969,SUB-DISTRICT,Sukinda,57,80344,40921,39423
21,382,02970,SUB-DISTRICT,Tomka,44,45810,23432,22378
21,382,02971,SUB-DISTRICT,Kaliapani ,30,27984,14170,13814
21,382,02972,SUB-DISTRICT,Kalinganagar ,33,49415,25061,24354
21,382,02973,SUB-DISTRICT,Jakhapura,11,17424,8799,8625
21,382,02974,SUB-DISTRICT,Jajapur Road ,41,41347,21178,20169
21,382,02975,SUB-DISTRICT,Korai ,140,96874,49208,47666
21,382,02976,SUB-DISTRICT,Panikoili ,81,65386,33539,31847
21,382,02977,SUB-DISTRICT,Jajapur    ,99,97401,49639,47762
21,382,02978,SUB-DISTRICT,Jajpur Sadar  ,147,127778,65202,62576
21,382,02979,SUB-DISTRICT,Dharmasala ,180,154248,78636,75612
21,382,02980,SUB-DISTRICT,Jenapur  ,79,77100,39281,37819
21,382,02981,SUB-DISTRICT,Kuakhia  ,115,111408,56897,54511
21,382,02982,SUB-DISTRICT,Badachana ,170,129826,66398,63428
21,382,02983,SUB-DISTRICT,Balichandrapur ,62,111449,56625,54824
21,382,02984,SUB-DISTRICT,Binjharpur ,131,187982,93343,94639
21,382,02985,SUB-DISTRICT,Bari - Ramachandrapur,81,123956,61866,62090
21,382,02986,SUB-DISTRICT,Mangalpur ,97,146363,72344,74019
21,383,00000,DISTRICT,Dhenkanal,1081,1075305,551326,523979
21,383,02987,SUB-DISTRICT,Parajang ,125,158056,80307,77749
21,383,02988,SUB-DISTRICT,Kamakshyanagar ,109,100286,51268,49018
21,383,02989,SUB-DISTRICT,Kankadahad  ,81,61222,30917,30305
21,383,02990,SUB-DISTRICT,Bhuban ,87,78851,40447,38404
21,383,02991,SUB-DISTRICT,Gandia ,120,104442,53238,51204
21,383,02992,SUB-DISTRICT,Nihalprasad ,52,53452,27270,26182
21,383,02993,SUB-DISTRICT,Tumusingha ,52,53802,27692,26110
21,383,02994,SUB-DISTRICT,Motunga ,58,62014,32296,29718
21,383,02995,SUB-DISTRICT,Bhusan Steel Limited,25,26821,14600,12221
21,383,02996,SUB-DISTRICT,Balimi ,45,47592,24376,23216
21,383,02997,SUB-DISTRICT,Hindol ,55,44159,22512,21647
21,383,02998,SUB-DISTRICT,Rasol ,60,73850,37597,36253
21,383,02999,SUB-DISTRICT,Dhenkanal Sadar ,212,210758,108806,101952
21,384,00000,DISTRICT,Anugul  ,1654,1067275,546385,520890
21,384,03000,SUB-DISTRICT,Palalahada ,142,60636,30736,29900
21,384,03001,SUB-DISTRICT,Khamar ,129,63421,32292,31129
21,384,03002,SUB-DISTRICT,Rengali Damsite ,40,31493,16409,15084
21,384,03003,SUB-DISTRICT,Kaniha ,81,55678,29108,26570
21,384,03004,SUB-DISTRICT,N.T.P.C.   ,15,16590,8682,7908
21,384,03005,SUB-DISTRICT,Samal Barrage ,41,28440,14830,13610
21,384,03006,SUB-DISTRICT,Talcher Sadar,104,57127,29793,27334
21,384,03007,SUB-DISTRICT,Colliery ,32,23225,12022,11203
21,384,03008,SUB-DISTRICT,Bikrampur ,12,19985,10587,9398
21,384,03009,SUB-DISTRICT,Nalco,9,19807,10442,9365
21,384,03010,SUB-DISTRICT,Banarpal,55,59302,30491,28811
21,384,02995,SUB-DISTRICT,Bhusan Steel Limited,2,1098,558,540
21,384,03011,SUB-DISTRICT,Anugul ,92,111408,57722,53686
21,384,03012,SUB-DISTRICT,Jarapada ,53,61335,31240,30095
21,384,03013,SUB-DISTRICT,Industrial  ,39,34314,17500,16814
21,384,03014,SUB-DISTRICT,Chhendipada ,111,103804,53195,50609
21,384,03015,SUB-DISTRICT,Handapa,93,51620,26258,25362
21,384,03016,SUB-DISTRICT,Kishorenagar ,139,56423,28192,28231
21,384,03017,SUB-DISTRICT,Athmallik ,117,44655,22456,22199
21,384,03018,SUB-DISTRICT,Kiakata,56,15777,7872,7905
21,384,03019,SUB-DISTRICT,Thakurgarh ,124,49898,24796,25102
21,384,03020,SUB-DISTRICT,Purunakot ,81,29526,14826,14700
21,384,03021,SUB-DISTRICT,Bantala ,87,71713,36378,35335
21,385,00000,DISTRICT,Nayagarh  ,1541,883051,461019,422032
21,385,03022,SUB-DISTRICT,Gania ,100,38506,20068,18438
21,385,03023,SUB-DISTRICT,Dasapalla ,190,70654,36515,34139
21,385,03024,SUB-DISTRICT,Banigochha ,161,26348,13123,13225
21,385,03025,SUB-DISTRICT,Nuagaon ,100,44036,22764,21272
21,385,03026,SUB-DISTRICT,Khandapada ,146,77995,40991,37004
21,385,03027,SUB-DISTRICT,Fategarh,138,125616,65660,59956
21,385,03028,SUB-DISTRICT,Nayagarh ,40,43006,22856,20150
21,385,03029,SUB-DISTRICT,Itamati ,54,61324,32591,28733
21,385,03030,SUB-DISTRICT,Nayagarh Sadar,78,48977,25863,23114
21,385,03031,SUB-DISTRICT,Odagaon,205,110626,57732,52894
21,385,03032,SUB-DISTRICT,Sarankul,110,106909,56644,50265
21,385,03033,SUB-DISTRICT,Ranapur ,219,129054,66212,62842
21,386,00000,DISTRICT,Khordha ,1356,1167357,595809,571548
21,386,03034,SUB-DISTRICT,Bolagad ,143,90794,46868,43926
21,386,03035,SUB-DISTRICT,Begunia,142,97166,49727,47439
21,386,03036,SUB-DISTRICT,Khordha ,87,93773,48415,45358
21,386,03037,SUB-DISTRICT,Khordha Sadar,68,57528,29355,28173
21,386,03038,SUB-DISTRICT,Chandaka,43,55468,28369,27099
21,386,03039,SUB-DISTRICT,Nandankanan,12,17670,9036,8634
21,386,03041,SUB-DISTRICT,Mancheswar,5,5117,2616,2501
21,386,03042,SUB-DISTRICT,Balianta ,80,78898,40269,38629
21,386,03043,SUB-DISTRICT,Balipatna,97,113650,58047,55603
21,386,03044,SUB-DISTRICT,Lingaraj,1,189,100,89
21,386,03045,SUB-DISTRICT,Airfield (Kapila Prasad),18,13445,6962,6483
21,386,03046,SUB-DISTRICT,Uttara,28,12941,6593,6348
21,386,03047,SUB-DISTRICT,Khandagiri ,4,2572,1326,1246
21,386,03048,SUB-DISTRICT,Tamando ,16,16406,8398,8008
21,386,03049,SUB-DISTRICT,Jatani,57,62708,31980,30728
21,386,03050,SUB-DISTRICT,Jankia ,102,84608,43224,41384
21,386,03051,SUB-DISTRICT,Nirakarpur,44,37980,19517,18463
21,386,03052,SUB-DISTRICT,Tangi,122,140668,71806,68862
21,386,03053,SUB-DISTRICT,Balugaon,123,89842,45120,44722
21,386,03054,SUB-DISTRICT,Banapur,164,95934,48081,47853
21,386,03055,SUB-DISTRICT,Bhubaneswar (M.Corp.),0,0,0,0
21,387,00000,DISTRICT,Puri,1600,1433800,728213,705587
21,387,03056,SUB-DISTRICT,Delanga,122,103324,52257,51067
21,387,03057,SUB-DISTRICT,Pipili ,192,142127,72595,69532
21,387,03058,SUB-DISTRICT,Nimapada,236,188850,95702,93148
21,387,03059,SUB-DISTRICT,Kakatpur,76,100525,51169,49356
21,387,03060,SUB-DISTRICT,Astaranga,84,67748,34363,33385
21,387,03061,SUB-DISTRICT,Konark,69,38220,19383,18837
21,387,03062,SUB-DISTRICT,Gop,142,121665,61659,60006
21,387,03063,SUB-DISTRICT,Ramachandi,29,22531,11424,11107
21,387,03064,SUB-DISTRICT,Satyabadi,169,196136,99599,96537
21,387,03065,SUB-DISTRICT,Chandanpur ,81,83245,42454,40791
21,387,03066,SUB-DISTRICT,Sadar ,97,107735,54725,53010
21,387,03067,SUB-DISTRICT,Brahmagiri,155,132319,67008,65311
21,387,03068,SUB-DISTRICT,Gadisagada,65,71870,36258,35612
21,387,03069,SUB-DISTRICT,Krushna Prasad ,83,57505,29617,27888
21,387,03070,SUB-DISTRICT,Puri (M),0,0,0,0
21,388,00000,DISTRICT,Ganjam,2783,2761030,1383636,1377394
21,388,03071,SUB-DISTRICT,Tarasingi,104,79336,40050,39286
21,388,03072,SUB-DISTRICT,Buguda,96,121036,59794,61242
21,388,03073,SUB-DISTRICT,Jagannath Prasad,76,79901,40186,39715
21,388,03074,SUB-DISTRICT,Bhanjanagar,131,133241,66787,66454
21,388,03075,SUB-DISTRICT,Gangapur,108,114480,56466,58014
21,388,03076,SUB-DISTRICT,Surada,106,72817,36650,36167
21,388,03077,SUB-DISTRICT,Badagada,242,118854,59192,59662
21,388,03078,SUB-DISTRICT,Asika,91,117359,58765,58594
21,388,03079,SUB-DISTRICT,Dharakote,54,53275,26819,26456
21,388,03080,SUB-DISTRICT,Kabisuryanagar,108,159210,79377,79833
21,388,03081,SUB-DISTRICT,Polasara,114,113584,57076,56508
21,388,03082,SUB-DISTRICT,Kodala,122,137353,69241,68112
21,388,03083,SUB-DISTRICT,Khalikote,131,127619,65746,61873
21,388,03084,SUB-DISTRICT,Rambha,86,78529,39603,38926
21,388,03085,SUB-DISTRICT,Chhatrapur,42,72656,36368,36288
21,388,03086,SUB-DISTRICT,Ganjam,20,27085,13272,13813
21,388,03087,SUB-DISTRICT,Chamakhandi,30,48236,23951,24285
21,388,03088,SUB-DISTRICT,Arjyapalli Marine ,0,0,0,0
21,388,03089,SUB-DISTRICT,Purusottampur,97,144503,71412,73091
21,388,03090,SUB-DISTRICT,Hinjili,70,133650,66665,66985
21,388,03091,SUB-DISTRICT,Patapur,136,133574,68111,65463
21,388,03092,SUB-DISTRICT,Seragad,50,59571,30347,29224
21,388,03093,SUB-DISTRICT,Brahmapur Sadar,49,104759,53727,51032
21,388,03094,SUB-DISTRICT,Gopalpur,24,50103,25695,24408
21,388,03095,SUB-DISTRICT,Golanthara,88,131331,65167,66164
21,388,03096,SUB-DISTRICT,Digapahandi,143,124049,62057,61992
21,388,03097,SUB-DISTRICT,Nuagaon,177,102791,51433,51358
21,388,03098,SUB-DISTRICT,Jarada,192,109142,53144,55998
21,388,03109,SUB-DISTRICT,Ramagiri,96,12986,6535,6451
21,388,03099,SUB-DISTRICT,Brahmapur (M.Corp.),0,0,0,0
21,389,00000,DISTRICT,Gajapati,1499,507151,247655,259496
21,389,03100,SUB-DISTRICT,Adva ,208,59262,28847,30415
21,389,03101,SUB-DISTRICT,Mohana ,264,69139,33763,35376
21,389,03102,SUB-DISTRICT,R.Udaygiri ,280,81383,39815,41568
21,389,03103,SUB-DISTRICT,Serango ,221,77720,37778,39942
21,389,03104,SUB-DISTRICT,Kashinagara ,72,42223,20921,21302
21,389,03105,SUB-DISTRICT,Parlakhemundi ,61,31373,15691,15682
21,389,03106,SUB-DISTRICT,Gurandi,73,45010,21970,23040
21,389,03107,SUB-DISTRICT,Rayagada ,111,41534,19834,21700
21,389,03108,SUB-DISTRICT,Garabandha,104,29492,14487,15005
21,389,03109,SUB-DISTRICT,Ramagiri,105,30015,14549,15466
21,390,00000,DISTRICT,Kandhamal,2417,660831,323523,337308
21,390,03110,SUB-DISTRICT,Gochhapada,227,35593,17391,18202
21,390,03111,SUB-DISTRICT,Phulabani ,240,41762,20689,21073
21,390,03112,SUB-DISTRICT,Phulabani Town  ,5,1361,672,689
21,390,03113,SUB-DISTRICT,Khajuripada,164,42560,21174,21386
21,390,03114,SUB-DISTRICT,G.Udayagiri,99,37544,18152,19392
21,390,03115,SUB-DISTRICT,Tikabali,156,48709,23744,24965
21,390,03116,SUB-DISTRICT,Chakapada ,82,22752,11320,11432
21,390,03117,SUB-DISTRICT,Sarangagarh ,97,35335,17338,17997
21,390,03118,SUB-DISTRICT,Phiringia ,234,53570,26113,27457
21,390,03119,SUB-DISTRICT,Baliguda,328,80473,39245,41228
21,390,03120,SUB-DISTRICT,Nuagaon,64,19364,9372,9992
21,390,03121,SUB-DISTRICT,Tumudibandha,91,28538,14113,14425
21,390,03122,SUB-DISTRICT,Belaghar ,130,19506,9381,10125
21,390,03123,SUB-DISTRICT,Kotagarh ,130,47900,23598,24302
21,390,03124,SUB-DISTRICT,Brahmanigaon ,86,36505,17760,18745
21,390,03125,SUB-DISTRICT,Daringbadi ,153,56529,27663,28866
21,390,03126,SUB-DISTRICT,Raikia,131,52830,25798,27032
21,391,00000,DISTRICT,Baudh,1117,420738,211133,209605
21,391,03127,SUB-DISTRICT,Kantamal ,217,77483,38719,38764
21,391,03128,SUB-DISTRICT,Manamunda,293,106227,53142,53085
21,391,03129,SUB-DISTRICT,Baunsuni ,84,43817,22021,21796
21,391,03130,SUB-DISTRICT,Baudh Sadar ,277,116974,59015,57959
21,391,03131,SUB-DISTRICT,Puruna Katak ,111,36887,18207,18680
21,391,03132,SUB-DISTRICT,Harbhanga ,135,39350,20029,19321
21,392,00000,DISTRICT,Subarnapur,856,560242,285634,274608
21,392,03133,SUB-DISTRICT,Dunguripali ,117,115713,59073,56640
21,392,03134,SUB-DISTRICT,Rampur ,44,43215,22327,20888
21,392,03135,SUB-DISTRICT,Binika,80,80869,41459,39410
21,392,03136,SUB-DISTRICT,Ulunda,102,41258,20946,20312
21,392,03137,SUB-DISTRICT,Biramaharajpur,176,100402,51273,49129
21,392,03138,SUB-DISTRICT,Subalaya,86,38492,19682,18810
21,392,03139,SUB-DISTRICT,Sonapur,68,39685,20203,19482
21,392,03140,SUB-DISTRICT,Tarbha,183,100608,50671,49937
21,393,00000,DISTRICT,Balangir,1751,1451616,728770,722846
21,393,03141,SUB-DISTRICT,Loisinga ,156,146645,73929,72716
21,393,03142,SUB-DISTRICT,Balangir,280,228843,116033,112810
21,393,03143,SUB-DISTRICT,Tushura,245,180205,90478,89727
21,393,03144,SUB-DISTRICT,Patnagarh,190,147301,73953,73348
21,393,03145,SUB-DISTRICT,Khaprakhol ,120,89819,44393,45426
21,393,03146,SUB-DISTRICT,Turekela ,72,52422,25994,26428
21,393,03147,SUB-DISTRICT,Belpara ,105,116136,58087,58049
21,393,03148,SUB-DISTRICT,Saintala,182,143560,72077,71483
21,393,03149,SUB-DISTRICT,Kantabanji,56,50296,25028,25268
21,393,03150,SUB-DISTRICT,Bangomunda,91,68820,34837,33983
21,393,03151,SUB-DISTRICT,Sindhekela ,106,98777,49620,49157
21,393,03152,SUB-DISTRICT,Titlagarh ,148,128792,64341,64451
21,394,00000,DISTRICT,Nuapada,656,576328,284792,291536
21,394,03153,SUB-DISTRICT,Jonk,70,56570,27842,28728
21,394,03154,SUB-DISTRICT,Nuapada,116,99624,49141,50483
21,394,03155,SUB-DISTRICT,Komna,154,127206,62655,64551
21,394,03156,SUB-DISTRICT,Khariar,117,111750,55641,56109
21,394,03157,SUB-DISTRICT,Boden,78,76670,37579,39091
21,394,03158,SUB-DISTRICT,Sinapali,121,104508,51934,52574
21,395,00000,DISTRICT,Kalahandi,2116,1454882,724646,730236
21,395,03159,SUB-DISTRICT,Kesinga,121,122126,61397,60729
21,395,03160,SUB-DISTRICT,Madanpur Rampur ,288,130050,65016,65034
21,395,03161,SUB-DISTRICT,Narala ,183,109499,54796,54703
21,395,03162,SUB-DISTRICT,Lanjigarh  ,197,47451,23555,23896
21,395,03163,SUB-DISTRICT,Biswanathpur ,120,23395,11365,12030
21,395,03164,SUB-DISTRICT,Sadar,296,150150,75012,75138
21,395,03165,SUB-DISTRICT,Kegaon ,107,102668,51395,51273
21,395,03166,SUB-DISTRICT,Junagarh,160,161993,80864,81129
21,395,03167,SUB-DISTRICT,Golamunda,72,78214,39240,38974
21,395,03168,SUB-DISTRICT,Dharamgarh,62,108110,54437,53673
21,395,03169,SUB-DISTRICT,Kokasara ,88,158742,78488,80254
21,395,03170,SUB-DISTRICT,Jayapatna,147,184644,90968,93676
21,395,03171,SUB-DISTRICT,Thuamul Rampur ,275,77840,38113,39727
21,396,00000,DISTRICT,Rayagada  ,2468,820945,397774,423171
21,396,03172,SUB-DISTRICT,Ambadala ,285,54514,27203,27311
21,396,03173,SUB-DISTRICT,Muniguda,138,46887,22787,24100
21,396,03174,SUB-DISTRICT,Chandrapur,129,28952,14438,14514
21,396,03175,SUB-DISTRICT,Bishamakatak,289,79496,37652,41844
21,396,03176,SUB-DISTRICT,Kalyanasingpur ,245,61369,28815,32554
21,396,03177,SUB-DISTRICT,Kashipur ,254,70542,34059,36483
21,396,03178,SUB-DISTRICT,Andirakanch ,39,15258,7449,7809
21,396,03179,SUB-DISTRICT,Tikiri ,73,35376,17476,17900
21,396,03180,SUB-DISTRICT,Doraguda ,53,19457,9307,10150
21,396,03181,SUB-DISTRICT,Rayagada ,318,132758,63813,68945
21,396,03182,SUB-DISTRICT,Seskhal ,137,47586,22574,25012
21,396,03183,SUB-DISTRICT,Gunupur,171,85986,41824,44162
21,396,03184,SUB-DISTRICT,Gudari ,187,58595,28794,29801
21,396,03185,SUB-DISTRICT,Padmapur,92,44779,22165,22614
21,396,03186,SUB-DISTRICT,Puttasing ,58,39390,19418,19972
21,397,00000,DISTRICT,Nabarangapur ,868,1133321,560771,572550
21,397,03187,SUB-DISTRICT,Raighar ,74,127601,63734,63867
21,397,03188,SUB-DISTRICT,Kundei ,43,50002,25144,24858
21,397,03189,SUB-DISTRICT,Umarkote,104,177019,88151,88868
21,397,03190,SUB-DISTRICT,Chandahandi ,87,73953,36460,37493
21,397,03191,SUB-DISTRICT,Jharigan,61,83006,40925,42081
21,397,03192,SUB-DISTRICT,Dabugan,135,155383,76542,78841
21,397,03193,SUB-DISTRICT,Paparahandi,68,90309,44622,45687
21,397,03194,SUB-DISTRICT,Kodinga,69,105973,52513,53460
21,397,03195,SUB-DISTRICT,Kosagumuda ,73,93166,45968,47198
21,397,03196,SUB-DISTRICT,Nabarangapur,59,82012,40440,41572
21,397,03197,SUB-DISTRICT,Tentulikhunti ,50,70316,34497,35819
21,397,03198,SUB-DISTRICT,Khatiguda,45,24581,11775,12806
21,398,00000,DISTRICT,Koraput,1941,1153478,563771,589707
21,398,03199,SUB-DISTRICT,Kotpad ,105,104603,51735,52868
21,398,03200,SUB-DISTRICT,Boriguma ,79,88556,43458,45098
21,398,03201,SUB-DISTRICT,Bhairabsingipur ,81,70420,34353,36067
21,398,03202,SUB-DISTRICT,Dasamantapur,111,50736,24764,25972
21,398,03203,SUB-DISTRICT,Lakshmipur,71,40232,19836,20396
21,398,03204,SUB-DISTRICT,Narayanpatana ,123,43575,21325,22250
21,398,03205,SUB-DISTRICT,Bandhugaon ,148,58974,28460,30514
21,398,03206,SUB-DISTRICT,Kakiriguma ,29,25329,12191,13138
21,398,03207,SUB-DISTRICT,Koraput ,123,68193,32883,35310
21,398,03208,SUB-DISTRICT,Koraput Town ,8,7364,3492,3872
21,398,03209,SUB-DISTRICT,Jeypore ,96,97076,47726,49350
21,398,03210,SUB-DISTRICT,Kundura,67,57038,27830,29208
21,398,03211,SUB-DISTRICT,Boipariguda ,296,125337,61225,64112
21,398,03212,SUB-DISTRICT,Machh kund ,115,41132,20065,21067
21,398,03213,SUB-DISTRICT,Padua ,102,54561,26444,28117
21,398,03214,SUB-DISTRICT,Nandapur,204,72579,35322,37257
21,398,03215,SUB-DISTRICT,Similiguda ,22,22247,10778,11469
21,398,03216,SUB-DISTRICT,Sunabeda,12,15270,7690,7580
21,398,03217,SUB-DISTRICT,Damonjodi,12,12065,5943,6122
21,398,03218,SUB-DISTRICT,Pottangi ,104,88128,43375,44753
21,398,03219,SUB-DISTRICT,Kotiya ,33,10063,4876,5187
21,399,00000,DISTRICT,Malkangiri  ,995,563664,277901,285763
21,399,03220,SUB-DISTRICT,Malkangiri,192,146650,72232,74418
21,399,03221,SUB-DISTRICT,Mathili ,138,84201,41700,42501
21,399,03222,SUB-DISTRICT,Mudulipada ,89,29614,14228,15386
21,399,03223,SUB-DISTRICT,Chitrakonda,88,26854,12904,13950
21,399,03224,SUB-DISTRICT,Paparmetla ,82,15232,7503,7729
21,399,03225,SUB-DISTRICT,Jodamba,84,14669,7241,7428
21,399,03226,SUB-DISTRICT,Orkel,98,62788,30439,32349
21,399,03227,SUB-DISTRICT,Kalimela ,105,76811,38331,38480
21,399,03228,SUB-DISTRICT,Podia,35,28264,14039,14225
21,399,03229,SUB-DISTRICT,M.V. 79,32,43705,21881,21824
21,399,03230,SUB-DISTRICT,Motu ,52,34876,17403,17473
22,000,00000,STATE,CHHATTISGARH,19567,19607961,9797426,9810535
22,400,00000,DISTRICT,Koriya,623,453618,228338,225280
22,400,03231,SUB-DISTRICT,Bharatpur,175,88750,44528,44222
22,400,03232,SUB-DISTRICT,Baikunthpur,125,126446,63770,62676
22,400,03233,SUB-DISTRICT,Sonhat,104,48474,24549,23925
22,400,03234,SUB-DISTRICT,Manendragarh,127,85508,43184,42324
22,400,03235,SUB-DISTRICT,Khadganva,92,104440,52307,52133
22,401,00000,DISTRICT,Surguja,1746,2116965,1067908,1049057
22,401,03236,SUB-DISTRICT,Ramanujganj,113,156173,79430,76743
22,401,03237,SUB-DISTRICT,Balrampur,122,105953,53794,52159
22,401,03238,SUB-DISTRICT,Wadrafnagar,119,154926,78724,76202
22,401,03239,SUB-DISTRICT,Pratappur,114,137920,69373,68547
22,401,03240,SUB-DISTRICT,Samri(kusmi),105,102484,51871,50613
22,401,03241,SUB-DISTRICT,Shankargarh,89,72088,36419,35669
22,401,03242,SUB-DISTRICT,Surajpur,119,189896,95495,94401
22,401,03243,SUB-DISTRICT,Oudgi,99,87603,44636,42967
22,401,03244,SUB-DISTRICT,Bhaiyathan,90,120012,60530,59482
22,401,03245,SUB-DISTRICT,Ramanujnagar,76,122233,61370,60863
22,401,03246,SUB-DISTRICT,Premnagar,46,59843,30061,29782
22,401,03247,SUB-DISTRICT,Ambikapur,122,158646,80057,78589
22,401,03248,SUB-DISTRICT,Lakhanpur,96,112699,56610,56089
22,401,03249,SUB-DISTRICT,Udaypur,87,78918,39780,39138
22,401,03250,SUB-DISTRICT,Rajpur,86,104184,52370,51814
22,401,03251,SUB-DISTRICT,Lundra,112,119800,60457,59343
22,401,03252,SUB-DISTRICT,Sitapur,51,86770,43134,43636
22,401,03253,SUB-DISTRICT,Batouli,54,70244,35094,35150
22,401,03254,SUB-DISTRICT,Mainpat,46,76573,38703,37870
22,402,00000,DISTRICT,Jashpur ,754,775677,386307,389370
22,402,03255,SUB-DISTRICT,Bagicha,137,161284,80569,80715
22,402,03256,SUB-DISTRICT,Kansabel,62,76735,37840,38895
22,402,03257,SUB-DISTRICT,Jashpur,96,68059,34111,33948
22,402,03258,SUB-DISTRICT,Manora,97,60695,30710,29985
22,402,03259,SUB-DISTRICT,Kunkuri,90,81454,40787,40667
22,402,03260,SUB-DISTRICT,Duldula,66,50840,25092,25748
22,402,03261,SUB-DISTRICT,Farsabahar,99,108498,53496,55002
22,402,03262,SUB-DISTRICT,Pathalgaon,107,168112,83702,84410
22,403,00000,DISTRICT,Raigarh,1426,1247682,623817,623865
22,403,03263,SUB-DISTRICT,Udaipur (Dharamjaigarh),190,192676,96031,96645
22,403,03264,SUB-DISTRICT,Lailunga,120,122405,60906,61499
22,403,03265,SUB-DISTRICT,Gharghoda,80,69970,34501,35469
22,403,03266,SUB-DISTRICT,Tamnar,116,97975,49342,48633
22,403,03267,SUB-DISTRICT,Raigarh,138,144392,73203,71189
22,403,03268,SUB-DISTRICT,Pusour,147,135055,67874,67181
22,403,03269,SUB-DISTRICT,Kharsia,136,131688,65444,66244
22,403,03270,SUB-DISTRICT,Sarangarh,274,214649,106744,107905
22,403,03271,SUB-DISTRICT,Baramkela,225,138872,69772,69100
22,404,00000,DISTRICT,Korba ,707,760350,381424,378926
22,404,03272,SUB-DISTRICT,Katghora,107,99506,49974,49532
22,404,03273,SUB-DISTRICT,Poundi-Uproda,209,188783,95083,93700
22,404,03274,SUB-DISTRICT,Pali,141,193232,97335,95897
22,404,03275,SUB-DISTRICT,Korba,129,133033,66214,66819
22,404,03276,SUB-DISTRICT,Kartala,121,145796,72818,72978
22,405,00000,DISTRICT,Janjgir - Champa,881,1394646,701401,693245
22,405,03277,SUB-DISTRICT,Janjgir,50,112499,57091,55408
22,405,03278,SUB-DISTRICT,Akaltara,79,153368,78300,75068
22,405,03279,SUB-DISTRICT,Baloda,69,89589,45183,44406
22,405,03280,SUB-DISTRICT,Nawagarh,69,139122,70459,68663
22,405,03281,SUB-DISTRICT,Champa,85,158717,80312,78405
22,405,03282,SUB-DISTRICT,Sakti,126,145729,72863,72866
22,405,03283,SUB-DISTRICT,Pamgarh,70,149823,75150,74673
22,405,03284,SUB-DISTRICT,Dabhra,124,149321,74629,74692
22,405,03285,SUB-DISTRICT,Malkharoda,108,140175,69822,70353
22,405,03286,SUB-DISTRICT,Jaijaipur,101,156303,77592,78711
22,406,00000,DISTRICT,Bilaspur,1566,1983759,1002520,981239
22,406,03287,SUB-DISTRICT,Pendra Road Gorella,85,115970,58382,57588
22,406,03288,SUB-DISTRICT,Marwahi,86,116804,57965,58839
22,406,03289,SUB-DISTRICT,Pendra,51,71361,35570,35791
22,406,03290,SUB-DISTRICT,Lormi,256,259703,131308,128395
22,406,03291,SUB-DISTRICT,Kota,162,185317,93339,91978
22,406,03292,SUB-DISTRICT,Mungeli,260,212779,107854,104925
22,406,03293,SUB-DISTRICT,Pathariya,151,163786,83146,80640
22,406,03294,SUB-DISTRICT,Takhatpur,174,248423,126544,121879
22,406,03295,SUB-DISTRICT,Bilaspur,84,192158,98076,94082
22,406,03296,SUB-DISTRICT,Masturi,171,289221,145570,143651
22,406,03297,SUB-DISTRICT,Bilha,86,128237,64766,63471
22,407,00000,DISTRICT,Kabeerdham,957,735131,367941,367190
22,407,03298,SUB-DISTRICT,Kawardha,181,175715,87861,87854
22,407,03299,SUB-DISTRICT,Bodla,314,181432,90637,90795
22,407,03300,SUB-DISTRICT,Sahaspur Lohara,187,145221,72292,72929
22,407,03301,SUB-DISTRICT,Pandariya,275,232763,117151,115612
22,408,00000,DISTRICT,Rajnandgaon,1600,1264621,626212,638409
22,408,03302,SUB-DISTRICT,Chhuikhadan,227,155851,77281,78570
22,408,03303,SUB-DISTRICT,Khairagarh,218,169658,83829,85829
22,408,03304,SUB-DISTRICT,Dongargarh,176,170745,84581,86164
22,408,03305,SUB-DISTRICT,Rajnandgaon,162,200238,100212,100026
22,408,03306,SUB-DISTRICT,Chhuriya,216,173997,85360,88637
22,408,03307,SUB-DISTRICT,Dongargaon,110,120074,59722,60352
22,408,03308,SUB-DISTRICT,Mohla,171,86994,42911,44083
22,408,03309,SUB-DISTRICT,Manpur,169,88619,44387,44232
22,408,03310,SUB-DISTRICT,Ambagarh,151,98445,47929,50516
22,409,00000,DISTRICT,Durg,1761,2059107,1026152,1032955
22,409,03311,SUB-DISTRICT,Nawagarh,185,179944,90246,89698
22,409,03312,SUB-DISTRICT,Bemetara,187,187088,93712,93376
22,409,03313,SUB-DISTRICT,Saja,108,102130,50983,51147
22,409,03314,SUB-DISTRICT,Thanakhamria,77,69819,34659,35160
22,409,03315,SUB-DISTRICT,Berla,132,182211,90768,91443
22,409,03316,SUB-DISTRICT,Dhamdha,162,204491,102361,102130
22,409,03317,SUB-DISTRICT,Durg,80,200696,101193,99503
22,409,03318,SUB-DISTRICT,Patan,142,212061,106147,105914
22,409,03319,SUB-DISTRICT,Gunderdehi,159,191287,95182,96105
22,409,03320,SUB-DISTRICT,Dondi Luhara,205,191366,94142,97224
22,409,03321,SUB-DISTRICT, Balod,91,101759,50260,51499
22,409,03322,SUB-DISTRICT,Dondi,112,96805,47191,49614
22,409,03323,SUB-DISTRICT,Gurur,121,139450,69308,70142
22,410,00000,DISTRICT,Raipur,2094,2580583,1288567,1292016
22,410,03324,SUB-DISTRICT,Simga,122,184855,92557,92298
22,410,03325,SUB-DISTRICT,Bhatapara,108,145758,72731,73027
22,410,03326,SUB-DISTRICT,Baloda Bazar,145,209012,104118,104894
22,410,03327,SUB-DISTRICT,Palari,132,193612,96589,97023
22,410,03328,SUB-DISTRICT,Kasdol,212,195406,97154,98252
22,410,03329,SUB-DISTRICT,Bilaigarh,219,210517,104827,105690
22,410,03330,SUB-DISTRICT,Arang,164,282591,142281,140310
22,410,03331,SUB-DISTRICT,Abhanpur,105,198342,99153,99189
22,410,03332,SUB-DISTRICT,Raipur,88,211052,106972,104080
22,410,03333,SUB-DISTRICT,Rajim,98,143812,71810,72002
22,410,03334,SUB-DISTRICT,Tilda,131,192239,96391,95848
22,410,03335,SUB-DISTRICT,Bindranavagarh(Gariyaband),151,84556,41557,42999
22,410,03336,SUB-DISTRICT,Chhura,158,110235,54268,55967
22,410,03337,SUB-DISTRICT,Mainpur,168,124384,61624,62760
22,410,03338,SUB-DISTRICT,Deobhog,93,94212,46535,47677
22,411,00000,DISTRICT,Mahasamund,1112,912602,451691,460911
22,411,03339,SUB-DISTRICT,Basna,215,165272,81706,83566
22,411,03340,SUB-DISTRICT,Saraipali,235,174954,86977,87977
22,411,03341,SUB-DISTRICT,Mahasamund,189,202308,100912,101396
22,411,03342,SUB-DISTRICT,Pithora,238,196238,96492,99746
22,411,03343,SUB-DISTRICT,Bagbahra,235,173830,85604,88226
22,412,00000,DISTRICT,Dhamtari ,619,650586,323420,327166
22,412,03344,SUB-DISTRICT,Kurud,132,197683,98759,98924
22,412,03345,SUB-DISTRICT,Magarlod,113,115150,57387,57763
22,412,03346,SUB-DISTRICT,Dhamtari,139,171556,85366,86190
22,412,03347,SUB-DISTRICT,Nagri,235,166197,81908,84289
22,413,00000,DISTRICT,Uttar Bastar Kanker,1063,672180,335149,337031
22,413,03348,SUB-DISTRICT,Charama,97,96755,47431,49324
22,413,03349,SUB-DISTRICT,Bhanupratappur,110,86812,42817,43995
22,413,03350,SUB-DISTRICT,Durgkondal,150,64293,32211,32082
22,413,03351,SUB-DISTRICT,Kanker,100,86208,42759,43449
22,413,03352,SUB-DISTRICT,Narharpur,118,105915,51711,54204
22,413,03353,SUB-DISTRICT,Antagarh,189,71398,35632,35766
22,413,03354,SUB-DISTRICT,Pakhanjur,299,160799,82588,78211
22,414,00000,DISTRICT,Bastar,1128,1219705,600652,619053
22,414,03355,SUB-DISTRICT,Keskal,101,81888,40157,41731
22,414,03356,SUB-DISTRICT,Bade Rajpur,55,75919,37370,38549
22,414,03357,SUB-DISTRICT,Kondagaon,182,170874,83693,87181
22,414,03358,SUB-DISTRICT,Makdi,96,99714,49189,50525
22,414,03359,SUB-DISTRICT,Farasgaon,103,92446,45392,47054
22,414,03360,SUB-DISTRICT,Jagdalpur,108,114345,56914,57431
22,414,03361,SUB-DISTRICT,Lohandiguda,82,75842,37209,38633
22,414,03362,SUB-DISTRICT,Bastanar,42,48040,23107,24933
22,414,03363,SUB-DISTRICT,Bastar,110,153949,76455,77494
22,414,03364,SUB-DISTRICT,Bakavand,111,149823,74622,75201
22,414,03365,SUB-DISTRICT,Tokapal,70,77505,37573,39932
22,414,03366,SUB-DISTRICT,Darbha,68,79360,38971,40389
22,415,00000,DISTRICT,Narayanpur,375,117714,58653,59061
22,415,03367,SUB-DISTRICT,Narayanpur,175,82764,41106,41658
22,415,03368,SUB-DISTRICT,Orchha,200,34950,17547,17403
22,416,00000,DISTRICT,Dakshin Bastar Dantewada,590,437405,213930,223475
22,416,03369,SUB-DISTRICT,Dantewada,56,59283,28640,30643
22,416,03370,SUB-DISTRICT,Gidam,67,66476,33246,33230
22,416,03371,SUB-DISTRICT,Katekalyan,43,43335,20737,22598
22,416,03372,SUB-DISTRICT,Kuakonda,53,46354,22370,23984
22,416,03373,SUB-DISTRICT,Konta,241,91320,45593,45727
22,416,03374,SUB-DISTRICT,Chhindgarh,78,79672,38599,41073
22,416,03375,SUB-DISTRICT,Sukma,52,50965,24745,26220
22,417,00000,DISTRICT,Bijapur,565,225630,113344,112286
22,417,03376,SUB-DISTRICT,Bhopalpattnam,130,44945,22581,22364
22,417,03377,SUB-DISTRICT,Usur,122,55686,28161,27525
22,417,03378,SUB-DISTRICT,Bijapur,95,50319,25170,25149
22,417,03379,SUB-DISTRICT,Bhairamgarh,218,74680,37432,37248
23,000,00000,STATE,MADHYA PRADESH,51929,52557404,27149388,25408016
23,418,00000,DISTRICT,Sheopur ,516,580509,305360,275149
23,418,03380,SUB-DISTRICT,Vijaypur,94,127573,68933,58640
23,418,03381,SUB-DISTRICT,Beerpur,68,87468,46420,41048
23,418,03382,SUB-DISTRICT,Sheopur,165,174030,90589,83441
23,418,03383,SUB-DISTRICT,Badoda,91,83177,43170,40007
23,418,03384,SUB-DISTRICT,Karahal,98,108261,56248,52013
23,419,00000,DISTRICT,Morena,775,1495508,815218,680290
23,419,03385,SUB-DISTRICT,Ambah,73,211512,114282,97230
23,419,03386,SUB-DISTRICT,Porsa,71,191485,103203,88282
23,419,03387,SUB-DISTRICT,Morena,176,359597,199098,160499
23,419,03388,SUB-DISTRICT,Joura,231,398111,217734,180377
23,419,03389,SUB-DISTRICT,Kailaras,105,165745,89731,76014
23,419,03390,SUB-DISTRICT,Sabalgarh,119,169058,91170,77888
23,420,00000,DISTRICT,Bhind,890,1270083,694756,575327
23,420,03391,SUB-DISTRICT,Ater,100,139378,75380,63998
23,420,03392,SUB-DISTRICT,Bhind,171,315413,171842,143571
23,420,03393,SUB-DISTRICT,Mehgaon,142,177008,97528,79480
23,420,03394,SUB-DISTRICT,Gormi,60,107933,59245,48688
23,420,03395,SUB-DISTRICT,Gohad,195,230248,126948,103300
23,420,03396,SUB-DISTRICT,Ron,45,78005,42390,35615
23,420,03397,SUB-DISTRICT,Mihona,44,72507,39734,32773
23,420,03398,SUB-DISTRICT,Lahar,133,149591,81689,67902
23,421,00000,DISTRICT,Gwalior,618,758244,409349,348895
23,421,03399,SUB-DISTRICT,Gwalior (Gird),309,392603,213532,179071
23,421,03400,SUB-DISTRICT,Dabra (Pichhore),151,182706,97890,84816
23,421,03401,SUB-DISTRICT,Bhitarwar,79,89630,48036,41594
23,421,03402,SUB-DISTRICT,Chinour,79,93305,49891,43414
23,422,00000,DISTRICT,Datia,586,604772,323966,280806
23,422,03403,SUB-DISTRICT,Seondha,96,93092,50598,42494
23,422,03404,SUB-DISTRICT,Indergarh,103,113876,61191,52685
23,422,03405,SUB-DISTRICT,Datia,247,263179,140251,122928
23,422,03406,SUB-DISTRICT,Bhander,140,134625,71926,62699
23,423,00000,DISTRICT,Shivpuri,1305,1430627,763554,667073
23,423,03407,SUB-DISTRICT,Pohri,238,207352,110643,96709
23,423,03408,SUB-DISTRICT,Shivpuri,181,160875,86204,74671
23,423,03409,SUB-DISTRICT,Narwar,145,179542,97496,82046
23,423,03410,SUB-DISTRICT,Karera,100,165614,88781,76833
23,423,03411,SUB-DISTRICT,Kolaras,191,143505,76274,67231
23,423,03412,SUB-DISTRICT,Badarwas,140,164181,86343,77838
23,423,03413,SUB-DISTRICT,Pichhore,172,241558,128580,112978
23,423,03414,SUB-DISTRICT,Khaniyadhana,138,168000,89233,78767
23,424,00000,DISTRICT,Tikamgarh,878,1195293,629477,565816
23,424,03415,SUB-DISTRICT,Niwari,89,136495,71591,64904
23,424,03416,SUB-DISTRICT,Orchha,32,35847,19115,16732
23,424,03417,SUB-DISTRICT,Prithvipur,132,153247,81096,72151
23,424,03418,SUB-DISTRICT,Jatara,99,168017,88623,79394
23,424,03419,SUB-DISTRICT,Mohangarh,74,88631,46704,41927
23,424,03420,SUB-DISTRICT,Palera,136,196047,102888,93159
23,424,03421,SUB-DISTRICT,Baldeogarh,87,114046,59794,54252
23,424,03422,SUB-DISTRICT,Khargapur,64,100046,53014,47032
23,424,03423,SUB-DISTRICT,Tikamgarh,165,202917,106652,96265
23,425,00000,DISTRICT,Chhatarpur,1085,1363359,725273,638086
23,425,03424,SUB-DISTRICT,Gaurihar,131,178175,95904,82271
23,425,03425,SUB-DISTRICT,Laundi,61,77944,41770,36174
23,425,03426,SUB-DISTRICT,Chandla,86,87763,47206,40557
23,425,03427,SUB-DISTRICT,Nowgong,74,123124,64667,58457
23,425,03428,SUB-DISTRICT,Maharajpur,44,68098,36174,31924
23,425,03429,SUB-DISTRICT,Chhatarpur,145,211833,112105,99728
23,425,03430,SUB-DISTRICT,Rajnagar,132,216270,114345,101925
23,425,03431,SUB-DISTRICT,Bada Malhera,100,92600,49286,43314
23,425,03432,SUB-DISTRICT,Ghuwara,53,85216,45374,39842
23,425,03433,SUB-DISTRICT,Bijawar,146,142275,75544,66731
23,425,03434,SUB-DISTRICT,Buxwaha,113,80061,42898,37163
23,426,00000,DISTRICT,Panna,947,891185,467473,423712
23,426,03435,SUB-DISTRICT,Ajaigarh,118,153801,81887,71914
23,426,03436,SUB-DISTRICT,Panna,117,97206,51588,45618
23,426,03437,SUB-DISTRICT,Devendranagar,67,67484,35304,32180
23,426,03438,SUB-DISTRICT,Gunnor,145,133513,69607,63906
23,426,03439,SUB-DISTRICT,Amanganj,111,100816,52918,47898
23,426,03440,SUB-DISTRICT,Pawai,172,153113,80194,72919
23,426,03441,SUB-DISTRICT,Shahnagar,117,107623,55839,51784
23,426,03442,SUB-DISTRICT,Raipura,100,77629,40136,37493
23,427,00000,DISTRICT,Sagar,1901,1669662,884133,785529
23,427,03443,SUB-DISTRICT,Bina,156,118623,63060,55563
23,427,03444,SUB-DISTRICT,Khurai,173,138091,73083,65008
23,427,03445,SUB-DISTRICT,Malthon,176,152631,80660,71971
23,427,03446,SUB-DISTRICT,Banda,164,171671,91157,80514
23,427,03447,SUB-DISTRICT,Shahgarh,110,121754,64987,56767
23,427,03448,SUB-DISTRICT,Rahatgarh,131,92562,49078,43484
23,427,03449,SUB-DISTRICT,Sagar,361,410831,217904,192927
23,427,03450,SUB-DISTRICT,Garhakota,101,85684,45145,40539
23,427,03451,SUB-DISTRICT,Rehli,120,109290,57743,51547
23,427,03452,SUB-DISTRICT,Kesli,175,116951,61569,55382
23,427,03453,SUB-DISTRICT,Deori,234,151574,79747,71827
23,428,00000,DISTRICT,Damoh,1176,1013668,530471,483197
23,428,03454,SUB-DISTRICT,Hatta,154,117137,61565,55572
23,428,03455,SUB-DISTRICT,Patera,156,124353,65175,59178
23,428,03456,SUB-DISTRICT,Batiyagarh,144,141466,74236,67230
23,428,03457,SUB-DISTRICT,Patharia,131,144719,76144,68575
23,428,03458,SUB-DISTRICT,Damoh,231,190401,99975,90426
23,428,03459,SUB-DISTRICT,Jabera,179,156995,81578,75417
23,428,03460,SUB-DISTRICT,Tendukheda,181,138597,71798,66799
23,429,00000,DISTRICT,Satna,1799,1754517,907904,846613
23,429,03461,SUB-DISTRICT,Raghurajnagar,236,207164,108242,98922
23,429,03462,SUB-DISTRICT,Majhgawan,166,118756,62149,56607
23,429,03463,SUB-DISTRICT,Birsinghpur,134,108436,56632,51804
23,429,03464,SUB-DISTRICT,Nagod,244,209823,109182,100641
23,429,03465,SUB-DISTRICT,Unchahara,214,172519,89176,83343
23,429,03466,SUB-DISTRICT,Rampur Baghelan,132,154489,79960,74529
23,429,03467,SUB-DISTRICT,Kotar,81,100030,51975,48055
23,429,03468,SUB-DISTRICT,Amarpatan,170,205353,105531,99822
23,429,03469,SUB-DISTRICT,Ramnagar,179,159414,81203,78211
23,429,03470,SUB-DISTRICT,Maihar,243,318533,163854,154679
23,430,00000,DISTRICT,Rewa,2408,1969321,1017839,951482
23,430,03471,SUB-DISTRICT,Teonthar,261,224136,116963,107173
23,430,03472,SUB-DISTRICT,Jawa,237,215071,111985,103086
23,430,03473,SUB-DISTRICT,Sirmour,178,174576,89613,84963
23,430,03474,SUB-DISTRICT,Mangawan,263,203226,104655,98571
23,430,03475,SUB-DISTRICT,Semaria,165,143108,73708,69400
23,430,03476,SUB-DISTRICT,Hanumana,293,238111,122723,115388
23,430,03477,SUB-DISTRICT,Mauganj,284,163291,83773,79518
23,430,03478,SUB-DISTRICT,Naigarhi,313,162637,84246,78391
23,430,03479,SUB-DISTRICT,Huzur,193,229104,118949,110155
23,430,03480,SUB-DISTRICT,Raipur - Karchuliyan,107,103346,53184,50162
23,430,03481,SUB-DISTRICT,Gurh,114,112715,58040,54675
23,431,00000,DISTRICT,Umaria,594,534214,273064,261150
23,431,03482,SUB-DISTRICT,Bandhogarh,101,91333,46626,44707
23,431,03483,SUB-DISTRICT,Chandia,126,89345,46077,43268
23,431,03484,SUB-DISTRICT,Manpur,211,228975,117072,111903
23,431,03485,SUB-DISTRICT,Pali,99,72667,36938,35729
23,431,03486,SUB-DISTRICT,Nowrozabad,57,51894,26351,25543
23,432,00000,DISTRICT,Neemuch ,675,580837,295013,285824
23,432,03487,SUB-DISTRICT,Jawad,108,110127,56078,54049
23,432,03488,SUB-DISTRICT,Singoli,157,87771,44715,43056
23,432,03489,SUB-DISTRICT,Neemuch,112,110958,56616,54342
23,432,03490,SUB-DISTRICT,Jiran,76,61311,31022,30289
23,432,03491,SUB-DISTRICT,Manasa,222,210670,106582,104088
23,433,00000,DISTRICT,Mandsaur,893,1062807,540987,521820
23,433,03492,SUB-DISTRICT,Bhanpura,82,123106,63386,59720
23,433,03493,SUB-DISTRICT,Malhargarh,168,170330,85911,84419
23,433,03494,SUB-DISTRICT,Garoth,101,120059,61102,58957
23,433,03495,SUB-DISTRICT,Shamgarh,94,101211,51676,49535
23,433,03496,SUB-DISTRICT,Mandsaur,158,194721,98906,95815
23,433,03497,SUB-DISTRICT,Daloda ,58,102538,51882,50656
23,433,03498,SUB-DISTRICT,Sitamau,159,175758,89681,86077
23,433,03499,SUB-DISTRICT,Suwasara,73,75084,38443,36641
23,434,00000,DISTRICT,Ratlam,1053,1020038,516468,503570
23,434,03500,SUB-DISTRICT,Piploda,90,130068,65952,64116
23,434,03501,SUB-DISTRICT,Jaora,145,159463,81215,78248
23,434,03502,SUB-DISTRICT,Alot,105,87855,44612,43243
23,434,03503,SUB-DISTRICT,Tal,86,92075,47100,44975
23,434,03504,SUB-DISTRICT,Sailana,239,122970,61735,61235
23,434,03505,SUB-DISTRICT,Bajna,127,80290,40361,39929
23,434,03506,SUB-DISTRICT,Rawti,93,84171,41893,42278
23,434,03507,SUB-DISTRICT,Ratlam,168,263146,133600,129546
23,435,00000,DISTRICT,Ujjain,1095,1207651,616353,591298
23,435,03508,SUB-DISTRICT,Khacharod,109,127079,64591,62488
23,435,03509,SUB-DISTRICT,Nagda,109,123183,62499,60684
23,435,03510,SUB-DISTRICT,Mahidpur,223,217329,111497,105832
23,435,03511,SUB-DISTRICT,Ghatiya,128,138861,70808,68053
23,435,03512,SUB-DISTRICT,Tarana,206,210713,107976,102737
23,435,03513,SUB-DISTRICT,Ujjain,131,157351,80030,77321
23,435,03514,SUB-DISTRICT,Badnagar,189,233135,118952,114183
23,436,00000,DISTRICT,Shajapur,1071,1219133,629273,589860
23,436,03515,SUB-DISTRICT,Susner,111,112615,57555,55060
23,436,03516,SUB-DISTRICT,Nalkheda,93,94685,48674,46011
23,436,03517,SUB-DISTRICT,Badod,139,121689,62346,59343
23,436,03518,SUB-DISTRICT,Agar,137,124960,64137,60823
23,436,03519,SUB-DISTRICT,Shajapur,144,162431,84207,78224
23,436,03520,SUB-DISTRICT,Gulana,93,133807,69398,64409
23,436,03521,SUB-DISTRICT,Moman Badodiya,102,115216,59549,55667
23,436,03522,SUB-DISTRICT,Shujalpur,131,164099,84941,79158
23,436,03523,SUB-DISTRICT,Kalapipal,121,189631,98466,91165
23,437,00000,DISTRICT,Dewas,1057,1111956,571720,540236
23,437,03524,SUB-DISTRICT,Tonk Khurd,108,125804,64575,61229
23,437,03525,SUB-DISTRICT,Sonkatch,128,133945,68536,65409
23,437,03526,SUB-DISTRICT,Dewas,221,216398,110962,105436
23,437,03527,SUB-DISTRICT,Kannod,64,94643,48714,45929
23,437,03528,SUB-DISTRICT,Satwas,97,112374,58165,54209
23,437,03529,SUB-DISTRICT,Bagli,177,173577,88462,85115
23,437,03530,SUB-DISTRICT,Hatpiplya,94,89193,45982,43211
23,437,03531,SUB-DISTRICT,Khategaon,168,166022,86324,79698
23,438,00000,DISTRICT,Dhar,1477,1772572,895113,877459
23,438,03532,SUB-DISTRICT,Badnawar,165,205523,103953,101570
23,438,03533,SUB-DISTRICT,Sardarpur,191,268552,136504,132048
23,438,03534,SUB-DISTRICT,Dhar,422,339043,172947,166096
23,438,03535,SUB-DISTRICT,Gandhwani,145,156046,77672,78374
23,438,03536,SUB-DISTRICT,Kukshi,194,284677,142249,142428
23,438,03537,SUB-DISTRICT,Dahi,61,105733,53261,52472
23,438,03538,SUB-DISTRICT,Manawar,198,277795,140183,137612
23,438,03539,SUB-DISTRICT,Dharampuri,101,135203,68344,66859
23,439,00000,DISTRICT,Indore,614,848988,436755,412233
23,439,03540,SUB-DISTRICT,Depalpur,146,180044,92410,87634
23,439,03541,SUB-DISTRICT,Hatod,59,71152,36273,34879
23,439,03542,SUB-DISTRICT,Sawer,125,171292,87819,83473
23,439,03543,SUB-DISTRICT,Indore,118,195847,101077,94770
23,439,03544,SUB-DISTRICT,Mhow ,166,230653,119176,111477
23,440,00000,DISTRICT,Khargone (West Nimar),1194,1574190,799396,774794
23,440,03545,SUB-DISTRICT,Barwaha,254,278531,142606,135925
23,440,03546,SUB-DISTRICT,Maheshwar,175,196278,99528,96750
23,440,03547,SUB-DISTRICT,Kasrawad,178,219959,112622,107337
23,440,03548,SUB-DISTRICT,Segaon,53,83487,42032,41455
23,440,03549,SUB-DISTRICT,Bhikangaon,131,175563,89089,86474
23,440,03550,SUB-DISTRICT,Khargone,91,113162,58017,55145
23,440,03551,SUB-DISTRICT,Gogaon,76,112458,57552,54906
23,440,03552,SUB-DISTRICT,Bhagwanpura,107,192996,96841,96155
23,440,03553,SUB-DISTRICT,Jhiranya,129,201756,101109,100647
23,441,00000,DISTRICT,Barwani ,696,1181812,594907,586905
23,441,03554,SUB-DISTRICT,Barwani,96,155557,78472,77085
23,441,03555,SUB-DISTRICT,Pati,109,162432,81796,80636
23,441,03556,SUB-DISTRICT,Thikri,54,72233,36990,35243
23,441,03557,SUB-DISTRICT,Anjad,46,63176,32068,31108
23,441,03558,SUB-DISTRICT,Rajpur,97,182156,91757,90399
23,441,03559,SUB-DISTRICT,Pansemal,103,130065,65205,64860
23,441,03560,SUB-DISTRICT,Niwali,68,112639,56108,56531
23,441,03561,SUB-DISTRICT,Sendhwa,77,174833,88051,86782
23,441,03562,SUB-DISTRICT,Varla,46,128721,64460,64261
23,442,00000,DISTRICT,Rajgarh,1677,1269357,648407,620950
23,442,03563,SUB-DISTRICT,Jirapur,215,168475,85240,83235
23,442,03564,SUB-DISTRICT,Khilchipur,317,163636,82839,80797
23,442,03565,SUB-DISTRICT,Rajgarh,375,199276,101753,97523
23,442,03566,SUB-DISTRICT,Biaora,277,220887,113597,107290
23,442,03567,SUB-DISTRICT,Sarangpur,135,148647,76148,72499
23,442,03568,SUB-DISTRICT,Narsinghgarh,240,235951,120991,114960
23,442,03569,SUB-DISTRICT,Pachore,118,132485,67839,64646
23,443,00000,DISTRICT,Vidisha,1536,1119257,591962,527295
23,443,03570,SUB-DISTRICT,Lateri,183,124793,66177,58616
23,443,03571,SUB-DISTRICT,Sironj,275,182120,96963,85157
23,443,03572,SUB-DISTRICT,Kurwai,206,143422,75707,67715
23,443,03573,SUB-DISTRICT,Basoda,176,130562,69129,61433
23,443,03574,SUB-DISTRICT,Tyonda,99,69136,36580,32556
23,443,03575,SUB-DISTRICT,Nateran,82,82718,43579,39139
23,443,03576,SUB-DISTRICT,Shamshabad,96,97169,51397,45772
23,443,03577,SUB-DISTRICT,Gyaraspur,117,69107,36495,32612
23,443,03578,SUB-DISTRICT,Gulabganj,75,54164,28394,25770
23,443,03579,SUB-DISTRICT,Vidisha,227,166066,87541,78525
23,444,00000,DISTRICT,Bhopal,501,454010,238025,215985
23,444,03580,SUB-DISTRICT,Berasia,290,232587,122462,110125
23,444,03581,SUB-DISTRICT,Huzur,211,221423,115563,105860
23,445,00000,DISTRICT,Sehore,1031,1062870,554636,508234
23,445,03582,SUB-DISTRICT,Sehore,154,165960,87204,78756
23,445,03583,SUB-DISTRICT,Shyampur,144,152354,80246,72108
23,445,03584,SUB-DISTRICT,Ashta,186,189752,98452,91300
23,445,03585,SUB-DISTRICT,Jawar,96,100255,51960,48295
23,445,03586,SUB-DISTRICT,Ichhawar,143,147086,76243,70843
23,445,03587,SUB-DISTRICT,Nasrullaganj,128,152475,79235,73240
23,445,03588,SUB-DISTRICT,Budni,82,75098,39688,35410
23,445,03589,SUB-DISTRICT,Rehti,98,79890,41608,38282
23,446,00000,DISTRICT,Raisen,1424,1028172,539960,488212
23,446,03590,SUB-DISTRICT,Raisen,214,173496,90791,82705
23,446,03591,SUB-DISTRICT,Gairatganj,163,106834,56323,50511
23,446,03592,SUB-DISTRICT,Begamganj,207,112479,59708,52771
23,446,03593,SUB-DISTRICT,Goharganj,219,161466,84619,76847
23,446,03594,SUB-DISTRICT,Baraily,111,107656,56873,50783
23,446,03595,SUB-DISTRICT,Badi,114,92100,48598,43502
23,446,03596,SUB-DISTRICT,Silwani,241,136151,70806,65345
23,446,03597,SUB-DISTRICT,Udaipura,155,137990,72242,65748
23,447,00000,DISTRICT,Betul,1344,1266211,640358,625853
23,447,03598,SUB-DISTRICT,Bhainsdehi,286,277334,140050,137284
23,447,03599,SUB-DISTRICT,Athner,98,94878,48292,46586
23,447,03600,SUB-DISTRICT,Betul ,189,166219,84661,81558
23,447,03601,SUB-DISTRICT,Chicholi,79,77513,38950,38563
23,447,03602,SUB-DISTRICT,Ghoda Dongri,160,139904,69991,69913
23,447,03603,SUB-DISTRICT,Shahpur,126,107350,54056,53294
23,447,03604,SUB-DISTRICT,Multai,254,257102,130341,126761
23,447,03605,SUB-DISTRICT,Amla,152,145911,74017,71894
23,448,00000,DISTRICT,Harda ,511,451101,233312,217789
23,448,03606,SUB-DISTRICT,Khirkiya,80,67309,34874,32435
23,448,03607,SUB-DISTRICT,Sirali,100,82167,42309,39858
23,448,03608,SUB-DISTRICT,Harda,73,79665,41314,38351
23,448,03609,SUB-DISTRICT,Handiya,99,71501,37319,34182
23,448,03610,SUB-DISTRICT,Timarni,53,54427,28376,26051
23,448,03611,SUB-DISTRICT,Rehatgaon,106,96032,49120,46912
23,449,00000,DISTRICT,Hoshangabad,921,851364,445062,406302
23,449,03612,SUB-DISTRICT,Seoni-Malwa,176,156688,81662,75026
23,449,03613,SUB-DISTRICT,Itarsi,122,123325,63831,59494
23,449,03614,SUB-DISTRICT,Hoshangabad,40,47761,25194,22567
23,449,03615,SUB-DISTRICT,Dolariya,52,48063,25119,22944
23,449,03616,SUB-DISTRICT,Babai,105,117623,61565,56058
23,449,03617,SUB-DISTRICT,Sohagpur,159,124144,65277,58867
23,449,03618,SUB-DISTRICT,Pipariya,144,108078,56906,51172
23,449,03619,SUB-DISTRICT,Bankhedi,123,125682,65508,60174
23,450,00000,DISTRICT,Katni ,905,1028499,525188,503311
23,450,03620,SUB-DISTRICT,Murwara,118,147636,75381,72255
23,450,03621,SUB-DISTRICT,Rithi,112,127211,64736,62475
23,450,03622,SUB-DISTRICT,Barhi,50,89566,45536,44030
23,450,03623,SUB-DISTRICT,Badwara,106,104196,53464,50732
23,450,03624,SUB-DISTRICT,Vijayraghavgarh,133,183147,93790,89357
23,450,03625,SUB-DISTRICT,Bahoriband,185,198914,101338,97576
23,450,03626,SUB-DISTRICT,Dhimarkheda,201,177829,90943,86886
23,451,00000,DISTRICT,Jabalpur,1377,1023255,527031,496224
23,451,03627,SUB-DISTRICT,Sihora,149,135599,69526,66073
23,451,03628,SUB-DISTRICT,Majholi,209,156088,80305,75783
23,451,03629,SUB-DISTRICT,Patan,217,130074,67624,62450
23,451,03630,SUB-DISTRICT,Shahpura,226,178109,92097,86012
23,451,03631,SUB-DISTRICT,Jabalpur,188,163522,85152,78370
23,451,03632,SUB-DISTRICT,Panagar,196,141276,73403,67873
23,451,03633,SUB-DISTRICT,Kundam,192,118587,58924,59663
23,452,00000,DISTRICT,Narsimhapur,1035,888314,462699,425615
23,452,03634,SUB-DISTRICT,Gotegaon,244,168055,87353,80702
23,452,03635,SUB-DISTRICT,Gadarwara,350,363742,190366,173376
23,452,03636,SUB-DISTRICT,Narsimhapur,200,152587,78894,73693
23,452,03637,SUB-DISTRICT,Kareli,139,122088,63411,58677
23,452,03638,SUB-DISTRICT,Tendukheda,102,81842,42675,39167
23,453,00000,DISTRICT,Dindori ,901,672206,335393,336813
23,453,03639,SUB-DISTRICT,Shahpura,301,206050,102720,103330
23,453,03640,SUB-DISTRICT,Dindori ,600,466156,232673,233483
23,454,00000,DISTRICT,Mandla,1203,924716,459151,465565
23,454,03641,SUB-DISTRICT,Niwas,174,116343,57517,58826
23,454,03642,SUB-DISTRICT,Narayanganj,185,108911,54565,54346
23,454,03643,SUB-DISTRICT,Mandla,171,151026,75722,75304
23,454,03644,SUB-DISTRICT,Ghughari,183,172823,84634,88189
23,454,03645,SUB-DISTRICT,Bichhiya,333,247895,123313,124582
23,454,03646,SUB-DISTRICT,Nainpur,157,127718,63400,64318
23,455,00000,DISTRICT,Chhindwara,1906,1585739,806199,779540
23,455,03647,SUB-DISTRICT,Tamia,174,114176,57684,56492
23,455,03648,SUB-DISTRICT,Amarwara,149,144922,73567,71355
23,455,03649,SUB-DISTRICT,Harrai,210,124188,61843,62345
23,455,03650,SUB-DISTRICT,Chaurai,184,176514,90994,85520
23,455,03651,SUB-DISTRICT,Jamai,261,182162,91621,90541
23,455,03652,SUB-DISTRICT,Parasia,90,83765,42610,41155
23,455,03653,SUB-DISTRICT,Umreth,101,91457,46365,45092
23,455,03654,SUB-DISTRICT,Chhindwara,124,147103,75293,71810
23,455,03655,SUB-DISTRICT,Mohkhed,182,168340,85755,82585
23,455,03656,SUB-DISTRICT,Sausar,130,118282,60833,57449
23,455,03657,SUB-DISTRICT,Bichhua,142,87691,44463,43228
23,455,03658,SUB-DISTRICT,Pandhurna,159,147139,75171,71968
23,456,00000,DISTRICT,Seoni,1579,1215241,612314,602927
23,456,03659,SUB-DISTRICT,Lakhnadon,287,190848,96444,94404
23,456,03660,SUB-DISTRICT,Chhapara,157,107653,54477,53176
23,456,03661,SUB-DISTRICT,Ghansaur,229,135542,68288,67254
23,456,03662,SUB-DISTRICT,Dhanora,114,85066,42997,42069
23,456,03663,SUB-DISTRICT,Keolari,182,148546,74430,74116
23,456,03664,SUB-DISTRICT,Seoni,289,245155,125383,119772
23,456,03665,SUB-DISTRICT,Barghat,138,185536,92107,93429
23,456,03666,SUB-DISTRICT,Kurai,183,116895,58188,58707
23,457,00000,DISTRICT,Balaghat,1272,1456882,719794,737088
23,457,03667,SUB-DISTRICT,Katangi,60,86448,42465,43983
23,457,03668,SUB-DISTRICT,Tirodi,65,70950,35232,35718
23,457,03669,SUB-DISTRICT,Waraseoni,76,148797,73639,75158
23,457,03670,SUB-DISTRICT,Khairlanji,81,147208,72616,74592
23,457,03671,SUB-DISTRICT,Lalbarra,107,165427,82084,83343
23,457,03672,SUB-DISTRICT,Balaghat,156,159449,78491,80958
23,457,03673,SUB-DISTRICT,Kirnapur,131,169753,84080,85673
23,457,03674,SUB-DISTRICT,Baihar,304,233526,115009,118517
23,457,03675,SUB-DISTRICT,Paraswada,163,101258,49732,51526
23,457,03676,SUB-DISTRICT,Lanji,129,174066,86446,87620
23,458,00000,DISTRICT,Guna,1264,928844,486127,442717
23,458,03677,SUB-DISTRICT,Guna,286,224458,117665,106793
23,458,03678,SUB-DISTRICT,Bamori,223,172131,89120,83011
23,458,03679,SUB-DISTRICT,Raghogarh,146,98234,51527,46707
23,458,03680,SUB-DISTRICT,Maksoodangarh,171,117978,61751,56227
23,458,03681,SUB-DISTRICT,Kumbhraj,148,99097,52025,47072
23,458,03682,SUB-DISTRICT,Aron,140,111418,58838,52580
23,458,03683,SUB-DISTRICT,Chachaura,150,105528,55201,50327
23,459,00000,DISTRICT,Ashoknagar,818,691387,363411,327976
23,459,03684,SUB-DISTRICT,Isagarh,177,163666,85703,77963
23,459,03685,SUB-DISTRICT,Chanderi,133,125249,65757,59492
23,459,03686,SUB-DISTRICT,Ashoknagar,180,133439,70114,63325
23,459,03687,SUB-DISTRICT,Shadhora,97,73653,38469,35184
23,459,03688,SUB-DISTRICT,Mungaoli,231,195380,103368,92012
23,460,00000,DISTRICT,Shahdol,814,846463,426583,419880
23,460,03689,SUB-DISTRICT,Beohari,136,188149,95922,92227
23,460,03690,SUB-DISTRICT,Jaisinghnagar,199,185061,93127,91934
23,460,03691,SUB-DISTRICT,Sohagpur,295,310761,156722,154039
23,460,03692,SUB-DISTRICT,Jaitpur,184,162492,80812,81680
23,461,00000,DISTRICT,Anuppur,562,543996,272030,271966
23,461,03693,SUB-DISTRICT,Kotma,69,58147,28943,29204
23,461,03694,SUB-DISTRICT,Anuppur,159,179834,90098,89736
23,461,03695,SUB-DISTRICT,Jaithari,67,84426,42153,42273
23,461,03696,SUB-DISTRICT,Pushparajgarh,267,221589,110836,110753
23,462,00000,DISTRICT,Sidhi,1025,1033912,527378,506534
23,462,03697,SUB-DISTRICT,Rampur Naikin,142,194456,99731,94725
23,462,03698,SUB-DISTRICT,Churhat,126,102128,51031,51097
23,462,03699,SUB-DISTRICT,Gopadbanas,202,235150,121343,113807
23,462,03700,SUB-DISTRICT,Sihawal,299,268934,136068,132866
23,462,03701,SUB-DISTRICT,Majhauli,124,151985,77956,74029
23,462,03702,SUB-DISTRICT,Kusmi,132,81259,41249,40010
23,463,00000,DISTRICT,Singrauli,727,951487,493324,458163
23,463,03703,SUB-DISTRICT,Chitrangi,300,330184,170595,159589
23,463,03704,SUB-DISTRICT,Deosar,223,324363,170347,154016
23,463,03705,SUB-DISTRICT,Singrauli,204,296940,152382,144558
23,464,00000,DISTRICT,Jhabua,783,933065,467468,465597
23,464,03706,SUB-DISTRICT,Thandla,112,166606,83515,83091
23,464,03707,SUB-DISTRICT,Petlawad,215,217626,108879,108747
23,464,03708,SUB-DISTRICT,Meghnagar,110,159015,80201,78814
23,464,03709,SUB-DISTRICT,Jhabua,251,287451,143308,144143
23,464,03710,SUB-DISTRICT,Ranapur,95,102367,51565,50802
23,465,00000,DISTRICT,Alirajpur,538,671925,333593,338332
23,465,03711,SUB-DISTRICT,Bhavra,50,80133,39957,40176
23,465,03712,SUB-DISTRICT,Jobat,148,179428,89312,90116
23,465,03713,SUB-DISTRICT,Alirajpur,340,412364,204324,208040
23,466,00000,DISTRICT,Khandwa (East Nimar),711,1050625,541183,509442
23,466,03714,SUB-DISTRICT,Harsud,92,105147,55015,50132
23,466,03715,SUB-DISTRICT,Khalwa,147,222512,113961,108551
23,466,03716,SUB-DISTRICT,Khandwa,221,357297,183955,173342
23,466,03717,SUB-DISTRICT,Punasa,165,213854,110301,103553
23,466,03718,SUB-DISTRICT,Pandhana,86,151815,77951,73864
23,467,00000,DISTRICT,Burhanpur,261,497560,254978,242582
23,467,03719,SUB-DISTRICT,Burhanpur,96,202979,105122,97857
23,467,03720,SUB-DISTRICT,Khaknar,81,133269,67413,65856
23,467,03721,SUB-DISTRICT,Nepanagar,84,161312,82443,78869
24,000,00000,STATE,GUJARAT,17843,34694609,17799159,16895450
24,468,00000,DISTRICT,Kachchh,877,1363836,713524,650312
24,468,03722,SUB-DISTRICT,Lakhpat,86,62552,32274,30278
24,468,03723,SUB-DISTRICT,Rapar,97,188908,96677,92231
24,468,03724,SUB-DISTRICT,Bhachau,69,146503,76236,70267
24,468,03725,SUB-DISTRICT,Anjar,66,148354,78229,70125
24,468,03726,SUB-DISTRICT,Bhuj,149,229755,116990,112765
24,468,03727,SUB-DISTRICT,Nakhatrana,120,146367,74380,71987
24,468,03728,SUB-DISTRICT,Abdasa,133,117538,61387,56151
24,468,03729,SUB-DISTRICT,Mandvi,92,151997,77908,74089
24,468,03730,SUB-DISTRICT,Mundra,59,132881,78986,53895
24,468,03731,SUB-DISTRICT,Gandhidham,6,38981,20457,18524
24,469,00000,DISTRICT,Banas Kantha,1233,2705591,1393741,1311850
24,469,03732,SUB-DISTRICT,Vav,120,246156,128166,117990
24,469,03733,SUB-DISTRICT,Tharad,134,299335,154618,144717
24,469,03734,SUB-DISTRICT,Dhanera,77,201163,104125,97038
24,469,03735,SUB-DISTRICT,Dantiwada,57,115221,59846,55375
24,469,03736,SUB-DISTRICT,Amirgadh,69,132354,67100,65254
24,469,03737,SUB-DISTRICT,Danta,182,207086,105704,101382
24,469,03738,SUB-DISTRICT,Vadgam,109,231947,117918,114029
24,469,03739,SUB-DISTRICT,Palanpur,115,278542,143075,135467
24,469,03740,SUB-DISTRICT,Deesa,148,471969,242824,229145
24,469,03741,SUB-DISTRICT,Deodar,70,163007,84395,78612
24,469,03742,SUB-DISTRICT,Bhabhar,51,101258,52617,48641
24,469,03743,SUB-DISTRICT,Kankrej,101,257553,133353,124200
24,470,00000,DISTRICT,Patan  ,517,1062653,548324,514329
24,470,03744,SUB-DISTRICT,Santalpur,73,128791,66720,62071
24,470,03745,SUB-DISTRICT,Radhanpur,56,104708,53675,51033
24,470,03746,SUB-DISTRICT,Sidhpur,53,141486,72614,68872
24,470,03747,SUB-DISTRICT,Patan,139,315743,163313,152430
24,470,03748,SUB-DISTRICT,Harij,39,74309,38545,35764
24,470,03749,SUB-DISTRICT,Sami,98,182805,94050,88755
24,470,03750,SUB-DISTRICT,Chanasma,59,114811,59407,55404
24,471,00000,DISTRICT,Mahesana,597,1520734,787175,733559
24,471,03751,SUB-DISTRICT,Satlasana,65,89546,46036,43510
24,471,03752,SUB-DISTRICT,Kheralu,51,111935,57656,54279
24,471,03753,SUB-DISTRICT,Unjha,31,118431,61326,57105
24,471,03754,SUB-DISTRICT,Visnagar,59,185493,96148,89345
24,471,03755,SUB-DISTRICT,Vadnagar,43,117655,60340,57315
24,471,03756,SUB-DISTRICT,Vijapur,64,222581,115491,107090
24,471,03757,SUB-DISTRICT,Mahesana,113,328076,170737,157339
24,471,03758,SUB-DISTRICT,Becharaji,51,87014,44612,42402
24,471,03759,SUB-DISTRICT,Kadi,120,260003,134829,125174
24,472,00000,DISTRICT,Sabar Kantha,1364,2064869,1056141,1008728
24,472,03760,SUB-DISTRICT,Khedbrahma,133,268142,135223,132919
24,472,03761,SUB-DISTRICT,Vijaynagar,85,97817,48826,48991
24,472,03762,SUB-DISTRICT,Vadali,56,71711,36580,35131
24,472,03763,SUB-DISTRICT,Idar,136,215598,110548,105050
24,472,03764,SUB-DISTRICT,Bhiloda,164,223142,112717,110425
24,472,03765,SUB-DISTRICT,Meghraj,128,155752,79153,76599
24,472,03766,SUB-DISTRICT,Himatnagar,129,224436,116258,108178
24,472,03767,SUB-DISTRICT,Prantij,64,137683,71473,66210
24,472,03768,SUB-DISTRICT,Talod,73,136126,70252,65874
24,472,03769,SUB-DISTRICT,Modasa,105,154977,79660,75317
24,472,03770,SUB-DISTRICT,Dhansura,72,106733,55408,51325
24,472,03771,SUB-DISTRICT,Malpur,98,91460,46741,44719
24,472,03772,SUB-DISTRICT,Bayad,121,181292,93302,87990
24,473,00000,DISTRICT,Gandhinagar,252,791126,408436,382690
24,473,03773,SUB-DISTRICT,Kalol,64,188550,97986,90564
24,473,03774,SUB-DISTRICT,Mansa,48,176220,91101,85119
24,473,03775,SUB-DISTRICT,Gandhinagar,48,200426,103558,96868
24,473,03776,SUB-DISTRICT,Dehgam,92,225930,115791,110139
24,474,00000,DISTRICT,Ahmadabad,506,1151178,595583,555595
24,474,03777,SUB-DISTRICT,Mandal,37,70346,36063,34283
24,474,03778,SUB-DISTRICT,Detroj-Rampura,55,83199,42958,40241
24,474,03779,SUB-DISTRICT,Viramgam,66,137462,71224,66238
24,474,03780,SUB-DISTRICT,Sanand,52,141955,73183,68772
24,474,03781,SUB-DISTRICT,Ahmadabad City,0,0,0,0
24,474,03782,SUB-DISTRICT,Daskroi,54,186782,95970,90812
24,474,03783,SUB-DISTRICT,Dholka,69,168907,88208,80699
24,474,03784,SUB-DISTRICT,Bavla,45,115733,60091,55642
24,474,03785,SUB-DISTRICT,Ranpur,33,75982,39000,36982
24,474,03786,SUB-DISTRICT,Barwala,26,58035,30103,27932
24,474,03787,SUB-DISTRICT,Dhandhuka,69,112777,58783,53994
24,475,00000,DISTRICT,Surendranagar,647,1259352,649475,609877
24,475,03788,SUB-DISTRICT,Halvad,67,138976,71453,67523
24,475,03789,SUB-DISTRICT,Dhrangadhra,63,142908,73429,69479
24,475,03790,SUB-DISTRICT,Dasada,87,150972,77830,73142
24,475,03791,SUB-DISTRICT,Lakhtar,43,75606,38932,36674
24,475,03792,SUB-DISTRICT,Wadhwan,45,105719,54320,51399
24,475,03793,SUB-DISTRICT,Muli,58,118902,61556,57346
24,475,03794,SUB-DISTRICT,Chotila,111,157140,81584,75556
24,475,03795,SUB-DISTRICT,Sayla,75,138643,71327,67316
24,475,03796,SUB-DISTRICT,Chuda,38,97916,50609,47307
24,475,03797,SUB-DISTRICT,Limbdi,60,132570,68435,64135
24,476,00000,DISTRICT,Rajkot,833,1590508,816264,774244
24,476,03798,SUB-DISTRICT,Maliya,44,62728,32306,30422
24,476,03799,SUB-DISTRICT,Morvi,74,146350,75865,70485
24,476,03800,SUB-DISTRICT,Tankara,47,87577,44516,43061
24,476,03801,SUB-DISTRICT,Wankaner,99,166278,84513,81765
24,476,03802,SUB-DISTRICT,Paddhari,57,64234,32752,31482
24,476,03803,SUB-DISTRICT,Rajkot,82,137307,70511,66796
24,476,03804,SUB-DISTRICT,Lodhika,38,56744,29815,26929
24,476,03805,SUB-DISTRICT,Kotda Sangani,39,62059,31732,30327
24,476,03806,SUB-DISTRICT,Jasdan,101,265641,135243,130398
24,476,03807,SUB-DISTRICT,Gondal,80,173353,89208,84145
24,476,03808,SUB-DISTRICT,Jamkandorna,47,78130,39923,38207
24,476,03809,SUB-DISTRICT,Upleta,49,100733,52039,48694
24,476,03810,SUB-DISTRICT,Dhoraji,30,70351,36187,34164
24,476,03811,SUB-DISTRICT,Jetpur,46,119023,61654,57369
24,477,00000,DISTRICT,Jamnagar,697,1189054,610088,578966
24,477,03812,SUB-DISTRICT,Okhamandal,39,51395,26272,25123
24,477,03813,SUB-DISTRICT,Khambhalia,81,179619,93970,85649
24,477,03814,SUB-DISTRICT,Jamnagar,99,202767,104799,97968
24,477,03815,SUB-DISTRICT,Jodiya,52,85958,43582,42376
24,477,03816,SUB-DISTRICT,Dhrol,41,53432,27377,26055
24,477,03817,SUB-DISTRICT,Kalavad,98,111415,56267,55148
24,477,03818,SUB-DISTRICT,Lalpur,72,118187,60516,57671
24,477,03819,SUB-DISTRICT,Kalyanpur,64,176256,89626,86630
24,477,03820,SUB-DISTRICT,Bhanvad,82,103419,52656,50763
24,477,03821,SUB-DISTRICT,Jamjodhpur,69,106606,55023,51583
24,478,00000,DISTRICT,Porbandar ,179,299775,153260,146515
24,478,03822,SUB-DISTRICT,Porbandar,74,167457,85688,81769
24,478,03823,SUB-DISTRICT,Ranavav,59,62678,31911,30767
24,478,03824,SUB-DISTRICT,Kutiyana,46,69640,35661,33979
24,479,00000,DISTRICT,Junagadh,901,1836670,940271,896399
24,479,03825,SUB-DISTRICT,Manavadar,55,86689,44736,41953
24,479,03826,SUB-DISTRICT,Vanthali,46,82635,43013,39622
24,479,03827,SUB-DISTRICT,Junagadh,66,114919,59737,55182
24,479,03828,SUB-DISTRICT,Bhesan,42,79712,40711,39001
24,479,03829,SUB-DISTRICT,Visavadar,85,120508,61715,58793
24,479,03830,SUB-DISTRICT,Mendarda,45,68531,35440,33091
24,479,03831,SUB-DISTRICT,Keshod,53,118553,61031,57522
24,479,03832,SUB-DISTRICT,Mangrol,63,143194,73588,69606
24,479,03833,SUB-DISTRICT,Malia,63,137461,70432,67029
24,479,03834,SUB-DISTRICT,Talala,67,114671,58815,55856
24,479,03835,SUB-DISTRICT,Patan-Veraval,54,136695,69903,66792
24,479,03836,SUB-DISTRICT,Sutrapada,46,115836,58754,57082
24,479,03837,SUB-DISTRICT,Kodinar,63,187317,94573,92744
24,479,03838,SUB-DISTRICT,Una,153,329949,167823,162126
24,480,00000,DISTRICT,Amreli,614,1127555,572554,555001
24,480,03839,SUB-DISTRICT,Kunkavav Vadia,45,99794,50438,49356
24,480,03840,SUB-DISTRICT,Babra,56,115251,58715,56536
24,480,03841,SUB-DISTRICT,Lathi,49,95127,48064,47063
24,480,03842,SUB-DISTRICT,Lilia,36,50064,25346,24718
24,480,03843,SUB-DISTRICT,Amreli,71,123312,62991,60321
24,480,03844,SUB-DISTRICT,Bagasara,31,48533,24419,24114
24,480,03845,SUB-DISTRICT,Dhari,75,123086,62720,60366
24,480,03846,SUB-DISTRICT,Savar Kundla,80,160918,81379,79539
24,480,03847,SUB-DISTRICT,Khambha,57,93431,47214,46217
24,480,03848,SUB-DISTRICT,Jafrabad,42,80835,41501,39334
24,480,03849,SUB-DISTRICT,Rajula,72,137204,69767,67437
24,481,00000,DISTRICT,Bhavnagar,783,1697964,868833,829131
24,481,03850,SUB-DISTRICT,Botad,52,156291,80074,76217
24,481,03851,SUB-DISTRICT,Vallabhipur,55,64340,33152,31188
24,481,03852,SUB-DISTRICT,Gadhada,73,156155,79430,76725
24,481,03853,SUB-DISTRICT,Umrala,40,70719,36320,34399
24,481,03854,SUB-DISTRICT,Bhavnagar,54,144056,75130,68926
24,481,03855,SUB-DISTRICT,Ghogha,46,88769,45891,42878
24,481,03856,SUB-DISTRICT,Sihor,78,151662,78379,73283
24,481,03857,SUB-DISTRICT,Gariadhar,50,84327,42694,41633
24,481,03858,SUB-DISTRICT,Palitana,93,165774,84424,81350
24,481,03859,SUB-DISTRICT,Talaja,111,271056,138613,132443
24,481,03860,SUB-DISTRICT,Mahuva,131,344815,174726,170089
24,482,00000,DISTRICT,Anand  ,347,1457758,758499,699259
24,482,03861,SUB-DISTRICT,Tarapur,42,88522,46032,42490
24,482,03862,SUB-DISTRICT,Sojitra,24,89813,46728,43085
24,482,03863,SUB-DISTRICT,Umreth,36,154267,80090,74177
24,482,03864,SUB-DISTRICT,Anand,37,263835,137018,126817
24,482,03865,SUB-DISTRICT,Petlad,56,232594,121320,111274
24,482,03866,SUB-DISTRICT,Khambhat,57,186515,97225,89290
24,482,03867,SUB-DISTRICT,Borsad,64,316107,164655,151452
24,482,03868,SUB-DISTRICT,Anklav,31,126105,65431,60674
24,483,00000,DISTRICT,Kheda,615,1776276,915197,861079
24,483,03869,SUB-DISTRICT,Kapadvanj,106,223860,114852,109008
24,483,03870,SUB-DISTRICT,Virpur,52,90055,46464,43591
24,483,03871,SUB-DISTRICT,Balasinor,46,106493,55198,51295
24,483,03872,SUB-DISTRICT,Kathlal,58,186555,95403,91152
24,483,03873,SUB-DISTRICT,Mehmedabad,65,220610,112359,108251
24,483,03874,SUB-DISTRICT,Kheda,39,102587,53126,49461
24,483,03875,SUB-DISTRICT,Matar,55,162800,84391,78409
24,483,03876,SUB-DISTRICT,Nadiad,59,267797,138526,129271
24,483,03877,SUB-DISTRICT,Mahudha,41,114838,59083,55755
24,483,03878,SUB-DISTRICT,Thasra,94,300681,155795,144886
24,484,00000,DISTRICT,Panch Mahals,1198,2055949,1053376,1002573
24,484,03879,SUB-DISTRICT,Khanpur,86,96041,49023,47018
24,484,03880,SUB-DISTRICT,Kadana,132,129545,66399,63146
24,484,03881,SUB-DISTRICT,Santrampur,152,246229,125790,120439
24,484,03882,SUB-DISTRICT,Lunawada,237,220274,113278,106996
24,484,03883,SUB-DISTRICT,Shehera,90,258384,132572,125812
24,484,03884,SUB-DISTRICT,Morwa (Hadaf),51,186920,94728,92192
24,484,03885,SUB-DISTRICT,Godhra,113,300080,153325,146755
24,484,03886,SUB-DISTRICT,Kalol,67,183839,95101,88738
24,484,03887,SUB-DISTRICT,Ghoghamba,95,218467,111591,106876
24,484,03888,SUB-DISTRICT,Halol,120,173694,89798,83896
24,484,03889,SUB-DISTRICT,Jambughoda,55,42476,21771,20705
24,485,00000,DISTRICT,Dohad  ,691,1935461,970963,964498
24,485,03890,SUB-DISTRICT,Fatepura,96,238116,119947,118169
24,485,03891,SUB-DISTRICT,Jhalod,149,437105,220544,216561
24,485,03892,SUB-DISTRICT,Limkheda,151,302345,150546,151799
24,485,03893,SUB-DISTRICT,Dohad,85,350342,175508,174834
24,485,03894,SUB-DISTRICT,Garbada,34,198879,99978,98901
24,485,03895,SUB-DISTRICT,Devgadbaria,86,228305,113618,114687
24,485,03896,SUB-DISTRICT,Dhanpur,90,180369,90822,89547
24,486,00000,DISTRICT,Vadodara,1533,2099855,1077943,1021912
24,486,03897,SUB-DISTRICT,Savli,136,236542,122696,113846
24,486,03898,SUB-DISTRICT,Vadodara,82,186902,96863,90039
24,486,03899,SUB-DISTRICT,Vaghodia,93,125862,64778,61084
24,486,03900,SUB-DISTRICT,Jetpur Pavi,212,253561,129755,123806
24,486,03901,SUB-DISTRICT,Chhota Udaipur,144,215590,108233,107357
24,486,03902,SUB-DISTRICT,Kavant,131,200449,100702,99747
24,486,03903,SUB-DISTRICT,Nasvadi,216,147367,74663,72704
24,486,03904,SUB-DISTRICT,Sankheda,185,182449,94349,88100
24,486,03905,SUB-DISTRICT,Dabhoi,118,129278,66914,62364
24,486,03906,SUB-DISTRICT,Padra,82,219241,114380,104861
24,486,03907,SUB-DISTRICT,Karjan,93,137174,70698,66476
24,486,03908,SUB-DISTRICT,Sinor,41,65440,33912,31528
24,487,00000,DISTRICT,Narmada,558,528425,269408,259017
24,487,03909,SUB-DISTRICT,Tilakwada,97,63871,33197,30674
24,487,03910,SUB-DISTRICT,Nandod,202,199420,103375,96045
24,487,03911,SUB-DISTRICT,Dediapada,168,165423,83451,81972
24,487,03912,SUB-DISTRICT,Sagbara,91,99711,49385,50326
24,488,00000,DISTRICT,Bharuch,647,1026060,529393,496667
24,488,03913,SUB-DISTRICT,Jambusar,81,153694,79981,73713
24,488,03914,SUB-DISTRICT,Amod,52,78582,40587,37995
24,488,03915,SUB-DISTRICT,Vagra,67,100044,53489,46555
24,488,03916,SUB-DISTRICT,Bharuch,89,185056,94641,90415
24,488,03917,SUB-DISTRICT,Jhagadia,164,185337,95085,90252
24,488,03918,SUB-DISTRICT,Anklesvar,54,123204,63457,59747
24,488,03919,SUB-DISTRICT,Hansot,45,55832,28659,27173
24,488,03920,SUB-DISTRICT,Valia,95,144311,73494,70817
24,489,00000,DISTRICT,The Dangs,308,203604,101710,101894
24,489,03921,SUB-DISTRICT,The Dangs,308,203604,101710,101894
24,490,00000,DISTRICT,Navsari  ,372,920535,464749,455786
24,490,03922,SUB-DISTRICT,Navsari,65,109692,55940,53752
24,490,03923,SUB-DISTRICT,Jalalpore,71,136071,69486,66585
24,490,03924,SUB-DISTRICT,Gandevi,55,154764,78000,76764
24,490,03925,SUB-DISTRICT,Chikhli,87,302852,152960,149892
24,490,03926,SUB-DISTRICT,Bansda,94,217156,108363,108793
24,491,00000,DISTRICT,Valsad,433,1070177,542644,527533
24,491,03927,SUB-DISTRICT,Valsad,85,222682,113554,109128
24,491,03928,SUB-DISTRICT,Dharampur,107,191694,95812,95882
24,491,03929,SUB-DISTRICT,Pardi,70,217341,112227,105114
24,491,03930,SUB-DISTRICT,Kaprada,128,258888,129916,128972
24,491,03931,SUB-DISTRICT,Umbergaon,43,179572,91135,88437
24,492,00000,DISTRICT,Surat,690,1232109,640060,592049
24,492,03932,SUB-DISTRICT,Olpad,103,162884,84751,78133
24,492,03933,SUB-DISTRICT,Mangrol,90,163598,85906,77692
24,492,03934,SUB-DISTRICT,Umarpada,63,83723,42093,41630
24,492,03935,SUB-DISTRICT,Mandvi,133,177735,88849,88886
24,492,03936,SUB-DISTRICT,Kamrej,68,178417,94003,84414
24,492,03937,SUB-DISTRICT,Surat City,0,0,0,0
24,492,03938,SUB-DISTRICT,Chorasi,37,86225,49973,36252
24,492,03939,SUB-DISTRICT,Palsana,46,86888,46647,40241
24,492,03940,SUB-DISTRICT,Bardoli,81,147733,74291,73442
24,492,03941,SUB-DISTRICT,Mahuva,69,144906,73547,71359
24,493,00000,DISTRICT,Tapi,451,727535,361548,365987
24,493,03942,SUB-DISTRICT,Nizar,51,129969,64433,65536
24,493,03943,SUB-DISTRICT,Uchchhal,40,88416,43670,44746
24,493,03944,SUB-DISTRICT,Songadh,172,190084,94689,95395
24,493,03945,SUB-DISTRICT,Vyara,148,228500,113191,115309
24,493,03946,SUB-DISTRICT,Valod,40,90566,45565,45001
25,000,00000,STATE,DAMAN & DIU,19,60396,32395,28001
25,494,00000,DISTRICT,Diu,4,28083,14028,14055
25,494,03947,SUB-DISTRICT,Diu,4,28083,14028,14055
25,495,00000,DISTRICT,Daman,15,32313,18367,13946
25,495,03948,SUB-DISTRICT,Daman,15,32313,18367,13946
26,000,00000,STATE,DADRA & NAGAR HAVELI,65,183114,98305,84809
26,496,00000,DISTRICT,Dadra & Nagar Haveli,65,183114,98305,84809
26,496,03949,SUB-DISTRICT,Dadra & Nagar Haveli,65,183114,98305,84809
27,000,00000,STATE,MAHARASHTRA,40959,61556074,31539034,30017040
27,497,00000,DISTRICT,Nandurbar,930,1372821,687671,685150
27,497,03950,SUB-DISTRICT,Akkalkuwa,189,215974,108251,107723
27,497,03951,SUB-DISTRICT,Akrani,162,189661,94690,94971
27,497,03952,SUB-DISTRICT,Talode,92,133291,66493,66798
27,497,03953,SUB-DISTRICT,Shahade,182,346352,174499,171853
27,497,03954,SUB-DISTRICT,Nandurbar,149,256409,129260,127149
27,497,03955,SUB-DISTRICT,Nawapur,156,231134,114478,116656
27,498,00000,DISTRICT,Dhule,674,1479826,758916,720910
27,498,03956,SUB-DISTRICT,Shirpur,145,345232,176012,169220
27,498,03957,SUB-DISTRICT,Sindkhede,141,276390,142499,133891
27,498,03958,SUB-DISTRICT,Sakri,225,435453,220832,214621
27,498,03959,SUB-DISTRICT,Dhule,163,422751,219573,203178
27,499,00000,DISTRICT,Jalgaon,1487,2887206,1500514,1386692
27,499,03960,SUB-DISTRICT,Chopda,112,240032,123976,116056
27,499,03961,SUB-DISTRICT,Yawal,89,208934,107343,101591
27,499,03962,SUB-DISTRICT,Raver,116,264459,136669,127790
27,499,03963,SUB-DISTRICT,Muktainagar,80,163444,84599,78845
27,499,03964,SUB-DISTRICT,Bodvad,51,91799,47588,44211
27,499,03965,SUB-DISTRICT,Bhusawal,50,112775,58443,54332
27,499,03966,SUB-DISTRICT,Jalgaon,86,215813,112866,102947
27,499,03967,SUB-DISTRICT,Erandol,64,135450,70304,65146
27,499,03968,SUB-DISTRICT,Dharangaon,88,138072,72232,65840
27,499,03969,SUB-DISTRICT,Amalner,153,191855,99029,92826
27,499,03970,SUB-DISTRICT,Parola,114,159197,83335,75862
27,499,03971,SUB-DISTRICT,Bhadgaon,59,125675,65176,60499
27,499,03972,SUB-DISTRICT,Chalisgaon,142,306698,160956,145742
27,499,03973,SUB-DISTRICT,Pachora,126,229808,119638,110170
27,499,03974,SUB-DISTRICT,Jamner,157,303195,158360,144835
27,500,00000,DISTRICT,Buldana,1300,2037398,1055242,982156
27,500,03975,SUB-DISTRICT,Jalgaon (Jamod),110,128347,65458,62889
27,500,03976,SUB-DISTRICT,Sangrampur,95,137092,70369,66723
27,500,03977,SUB-DISTRICT,Shegaon,67,96444,50129,46315
27,500,03978,SUB-DISTRICT,Nandura,102,131599,67801,63798
27,500,03979,SUB-DISTRICT,Malkapur,66,110794,57308,53486
27,500,03980,SUB-DISTRICT,Motala,109,166598,85986,80612
27,500,03981,SUB-DISTRICT,Khamgaon,135,226453,117472,108981
27,500,03982,SUB-DISTRICT,Mehkar,139,223068,115612,107456
27,500,03983,SUB-DISTRICT,Chikhli,134,227432,117528,109904
27,500,03984,SUB-DISTRICT,Buldana,96,206244,107518,98726
27,500,03985,SUB-DISTRICT,Deolgaon Raja,60,94523,49436,45087
27,500,03986,SUB-DISTRICT,Sindkhed Raja,104,159869,83470,76399
27,500,03987,SUB-DISTRICT,Lonar,83,128935,67155,61780
27,501,00000,DISTRICT,Akola,864,1094165,563933,530232
27,501,03988,SUB-DISTRICT,Telhara,94,151373,77848,73525
27,501,03989,SUB-DISTRICT,Akot,148,162903,83670,79233
27,501,03990,SUB-DISTRICT,Balapur,88,144818,74462,70356
27,501,03991,SUB-DISTRICT,Akola,174,233718,120632,113086
27,501,03992,SUB-DISTRICT,Murtijapur,148,134355,69380,64975
27,501,03993,SUB-DISTRICT,Patur,86,117635,60765,56870
27,501,03994,SUB-DISTRICT,Barshitakli,126,149363,77176,72187
27,502,00000,DISTRICT,Washim,698,985747,511727,474020
27,502,03995,SUB-DISTRICT,Malegaon,116,189051,98035,91016
27,502,03996,SUB-DISTRICT,Mangrulpir,119,144225,74919,69306
27,502,03997,SUB-DISTRICT,Karanja,133,145917,75060,70857
27,502,03998,SUB-DISTRICT,Manora,113,156344,80931,75413
27,502,03999,SUB-DISTRICT,Washim,121,176801,92496,84305
27,502,04000,SUB-DISTRICT,Risod,96,173409,90286,83123
27,503,00000,DISTRICT,Amravati,1637,1851158,950633,900525
27,503,04001,SUB-DISTRICT,Dharni,152,168904,85823,83081
27,503,04002,SUB-DISTRICT,Chikhaldara,161,113657,57934,55723
27,503,04003,SUB-DISTRICT,Anjangaon Surji,105,104523,53662,50861
27,503,04004,SUB-DISTRICT,Achalpur,140,167168,85758,81410
27,503,04005,SUB-DISTRICT,Chandurbazar,136,177499,91200,86299
27,503,04006,SUB-DISTRICT,Morshi,104,145151,74752,70399
27,503,04007,SUB-DISTRICT,Warud,124,157754,81278,76476
27,503,04008,SUB-DISTRICT,Teosa,71,104728,53811,50917
27,503,04009,SUB-DISTRICT,Amravati,109,141270,73234,68036
27,503,04010,SUB-DISTRICT,Bhatkuli,109,113109,58015,55094
27,503,04011,SUB-DISTRICT,Daryapur,133,138598,71090,67508
27,503,04012,SUB-DISTRICT,Nandgaon-Khandeshwar,131,129810,66661,63149
27,503,04013,SUB-DISTRICT,Chandur Railway,78,77131,39745,37386
27,503,04014,SUB-DISTRICT,Dhamangaon Railway,84,111856,57670,54186
27,504,00000,DISTRICT,Wardha,973,877474,451874,425600
27,504,04015,SUB-DISTRICT,Ashti,84,76276,39319,36957
27,504,04016,SUB-DISTRICT,Karanja,95,90462,46237,44225
27,504,04017,SUB-DISTRICT,Arvi,146,103159,53221,49938
27,504,04018,SUB-DISTRICT,Seloo,133,116789,59970,56819
27,504,04019,SUB-DISTRICT,Wardha,107,144874,74564,70310
27,504,04020,SUB-DISTRICT,Deoli,104,106664,54717,51947
27,504,04021,SUB-DISTRICT,Hinganghat,138,122212,63258,58954
27,504,04022,SUB-DISTRICT,Samudrapur,166,117038,60588,56450
27,505,00000,DISTRICT,Nagpur,1617,1474811,758357,716454
27,505,04023,SUB-DISTRICT,Narkhed,128,118003,60742,57261
27,505,04024,SUB-DISTRICT,Katol,163,120541,61853,58688
27,505,04025,SUB-DISTRICT,Kalameshwar,97,85457,43904,41553
27,505,04026,SUB-DISTRICT,Savner,123,127436,65923,61513
27,505,04027,SUB-DISTRICT,Parseoni,107,95709,48895,46814
27,505,04028,SUB-DISTRICT,Ramtek,145,131234,66801,64433
27,505,04029,SUB-DISTRICT,Mauda,118,125170,64655,60515
27,505,04030,SUB-DISTRICT,Kamptee,73,96091,49877,46214
27,505,04031,SUB-DISTRICT,Nagpur (Rural),138,148418,76606,71812
27,505,04032,SUB-DISTRICT,Nagpur (Urban),0,0,0,0
27,505,04033,SUB-DISTRICT,Hingna,126,121047,63421,57626
27,505,04034,SUB-DISTRICT,Umred,139,100209,51598,48611
27,505,04035,SUB-DISTRICT,Kuhi,151,123977,63104,60873
27,505,04036,SUB-DISTRICT,Bhiwapur,109,81519,40978,40541
27,506,00000,DISTRICT,Bhandara,771,966503,487484,479019
27,506,04037,SUB-DISTRICT,Tumsar,135,176887,88806,88081
27,506,04038,SUB-DISTRICT,Mohadi,101,137553,69527,68026
27,506,04039,SUB-DISTRICT,Bhandara,138,153511,77910,75601
27,506,04040,SUB-DISTRICT,Sakoli,85,122243,61960,60283
27,506,04041,SUB-DISTRICT,Lakhani,94,120969,60923,60046
27,506,04042,SUB-DISTRICT,Pauni,135,131767,66334,65433
27,506,04043,SUB-DISTRICT,Lakhandur,83,123573,62024,61549
27,507,00000,DISTRICT,Gondiya,883,1096577,547934,548643
27,507,04044,SUB-DISTRICT,Tirora,114,151073,76216,74857
27,507,04045,SUB-DISTRICT,Goregaon,94,124890,62022,62868
27,507,04046,SUB-DISTRICT,Gondiya,146,258574,128568,130006
27,507,04047,SUB-DISTRICT,Amgaon,81,112760,56169,56591
27,507,04048,SUB-DISTRICT,Salekasa,85,85482,42598,42884
27,507,04049,SUB-DISTRICT,Sadak-Arjuni,101,115594,58201,57393
27,507,04050,SUB-DISTRICT,Arjuni Morgaon,138,148265,74703,73562
27,507,04051,SUB-DISTRICT,Deori,124,99939,49457,50482
27,508,00000,DISTRICT,Gadchiroli,1509,954909,481290,473619
27,508,04052,SUB-DISTRICT,Desaiganj (Vadasa),30,54826,27626,27200
27,508,04053,SUB-DISTRICT,Armori,91,97097,48887,48210
27,508,04054,SUB-DISTRICT,Kurkheda,119,78643,39784,38859
27,508,04055,SUB-DISTRICT,Korchi,125,42811,21087,21724
27,508,04056,SUB-DISTRICT,Dhanora,219,82698,41529,41169
27,508,04057,SUB-DISTRICT,Gadchiroli,106,91811,46705,45106
27,508,04058,SUB-DISTRICT,Chamorshi,185,173486,87873,85613
27,508,04059,SUB-DISTRICT,Mulchera,67,45787,23438,22349
27,508,04060,SUB-DISTRICT,Etapalli,186,81713,40959,40754
27,508,04061,SUB-DISTRICT,Bhamragad,110,36325,18319,18006
27,508,04062,SUB-DISTRICT,Aheri,157,102383,51317,51066
27,508,04063,SUB-DISTRICT,Sironcha,114,67329,33766,33563
27,509,00000,DISTRICT,Chandrapur,1463,1428929,726106,702823
27,509,04064,SUB-DISTRICT,Warora,148,125008,64116,60892
27,509,04065,SUB-DISTRICT,Chimur,176,169547,85898,83649
27,509,04066,SUB-DISTRICT,Nagbhir,112,133020,66886,66134
27,509,04067,SUB-DISTRICT,Brahmapuri,110,130140,65628,64512
27,509,04068,SUB-DISTRICT,Sawali,94,107937,54291,53646
27,509,04069,SUB-DISTRICT,Sindewahi,94,110440,55784,54656
27,509,04070,SUB-DISTRICT,Bhadravati,115,84309,43358,40951
27,509,04071,SUB-DISTRICT,Chandrapur,83,79936,41268,38668
27,509,04072,SUB-DISTRICT,Mul,80,89162,44594,44568
27,509,04073,SUB-DISTRICT,Pombhurna,58,50781,25648,25133
27,509,04074,SUB-DISTRICT,Ballarpur,28,31854,16741,15113
27,509,04075,SUB-DISTRICT,Korpana,98,84302,43427,40875
27,509,04076,SUB-DISTRICT,Jiwati,83,61820,31483,30337
27,509,04077,SUB-DISTRICT,Rajura,96,99475,50971,48504
27,509,04078,SUB-DISTRICT,Gondpipri,88,71198,36013,35185
27,510,00000,DISTRICT,Yavatmal,1853,2174195,1115148,1059047
27,510,04079,SUB-DISTRICT,Ner,88,90930,46645,44285
27,510,04080,SUB-DISTRICT,Babulgaon,107,88173,45120,43053
27,510,04081,SUB-DISTRICT,Kalamb,126,103024,52461,50563
27,510,04082,SUB-DISTRICT,Yavatmal,125,145347,74279,71068
27,510,04083,SUB-DISTRICT,Darwha,129,157009,80595,76414
27,510,04084,SUB-DISTRICT,Digras,77,109355,56626,52729
27,510,04085,SUB-DISTRICT,Pusad,177,258191,133427,124764
27,510,04086,SUB-DISTRICT,Umarkhed,128,211899,108940,102959
27,510,04087,SUB-DISTRICT,Mahagaon,112,190252,98088,92164
27,510,04088,SUB-DISTRICT,Arni,105,161833,82745,79088
27,510,04089,SUB-DISTRICT,Ghatanji,105,117294,60131,57163
27,510,04090,SUB-DISTRICT,Kelapur,125,125689,63608,62081
27,510,04091,SUB-DISTRICT,Ralegaon,110,112203,57384,54819
27,510,04092,SUB-DISTRICT,Maregaon,95,78713,40099,38614
27,510,04093,SUB-DISTRICT,Zari-Jamani,104,80147,40364,39783
27,510,04094,SUB-DISTRICT,Wani,140,144136,74636,69500
27,511,00000,DISTRICT,Nanded,1541,2447394,1258160,1189234
27,511,04095,SUB-DISTRICT,Mahoor,88,99940,51465,48475
27,511,04096,SUB-DISTRICT,Kinwat,178,207732,105566,102166
27,511,04097,SUB-DISTRICT,Himayatnagar,70,109727,56332,53395
27,511,04098,SUB-DISTRICT,Hadgaon,148,232553,120081,112472
27,511,04099,SUB-DISTRICT,Ardhapur,52,109332,56592,52740
27,511,04100,SUB-DISTRICT,Nanded,83,137229,71413,65816
27,511,04101,SUB-DISTRICT,Mudkhed,51,92179,47234,44945
27,511,04102,SUB-DISTRICT,Bhokar,80,105414,53963,51451
27,511,04103,SUB-DISTRICT,Umri,65,85518,43640,41878
27,511,04104,SUB-DISTRICT,Dharmabad,51,63035,31733,31302
27,511,04105,SUB-DISTRICT,Biloli,83,140476,71813,68663
27,511,04106,SUB-DISTRICT,Naigaon (Khairgaon),87,182868,93913,88955
27,511,04107,SUB-DISTRICT,Loha,123,217760,112383,105377
27,511,04108,SUB-DISTRICT,Kandhar,125,224027,115905,108122
27,511,04109,SUB-DISTRICT,Mukhed,151,266235,137613,128622
27,511,04110,SUB-DISTRICT,Deglur,106,173369,88514,84855
27,512,00000,DISTRICT,Hingoli,675,998612,514430,484182
27,512,04111,SUB-DISTRICT,Sengaon,128,204122,105810,98312
27,512,04112,SUB-DISTRICT,Hingoli,140,184443,94970,89473
27,512,04113,SUB-DISTRICT,Aundha (Nagnath),118,181148,93094,88054
27,512,04114,SUB-DISTRICT,Kalamnuri,142,206775,106539,100236
27,512,04115,SUB-DISTRICT,Basmath,147,222124,114017,108107
27,513,00000,DISTRICT,Parbhani,830,1266280,651886,614394
27,513,04116,SUB-DISTRICT,Sailu,93,122259,62505,59754
27,513,04117,SUB-DISTRICT,Jintur,166,238465,122266,116199
27,513,04118,SUB-DISTRICT,Parbhani,128,230640,118765,111875
27,513,04119,SUB-DISTRICT,Manwath,54,84329,43223,41106
27,513,04120,SUB-DISTRICT,Pathri,56,102193,52457,49736
27,513,04121,SUB-DISTRICT,Sonpeth,57,73817,38130,35687
27,513,04122,SUB-DISTRICT,Gangakhed,105,152976,79301,73675
27,513,04123,SUB-DISTRICT,Palam,81,115382,59737,55645
27,513,04124,SUB-DISTRICT,Purna,90,146219,75502,70717
27,514,00000,DISTRICT,Jalna,958,1581617,817279,764338
27,514,04125,SUB-DISTRICT,Bhokardan,157,286887,148722,138165
27,514,04126,SUB-DISTRICT,Jafferabad,100,163120,84450,78670
27,514,04127,SUB-DISTRICT,Jalna,147,233441,121069,112372
27,514,04128,SUB-DISTRICT,Badnapur,91,153772,79500,74272
27,514,04129,SUB-DISTRICT,Ambad,137,224156,115434,108722
27,514,04130,SUB-DISTRICT,Ghansawangi,117,211108,108705,102403
27,514,04131,SUB-DISTRICT,Partur,95,141706,72765,68941
27,514,04132,SUB-DISTRICT,Mantha,114,167427,86634,80793
27,515,00000,DISTRICT,Aurangabad,1314,2081112,1081825,999287
27,515,04133,SUB-DISTRICT,Kannad,209,300260,156496,143764
27,515,04134,SUB-DISTRICT,Soegaon,78,113087,58896,54191
27,515,04135,SUB-DISTRICT,Sillod,127,301733,156949,144784
27,515,04136,SUB-DISTRICT,Phulambri,92,161012,83591,77421
27,515,04137,SUB-DISTRICT,Aurangabad,173,281268,147919,133349
27,515,04138,SUB-DISTRICT,Khuldabad,74,102579,53113,49466
27,515,04139,SUB-DISTRICT,Vaijapur,165,270075,139583,130492
27,515,04140,SUB-DISTRICT,Gangapur,212,256168,132914,123254
27,515,04141,SUB-DISTRICT,Paithan,184,294930,152364,142566
27,516,00000,DISTRICT,Nashik,1919,3509814,1804712,1705102
27,516,04142,SUB-DISTRICT,Surgana,190,169553,84667,84886
27,516,04143,SUB-DISTRICT,Kalwan,152,208362,106130,102232
27,516,04144,SUB-DISTRICT,Deola,50,144522,75306,69216
27,516,04145,SUB-DISTRICT,Baglan,169,336734,173623,163111
27,516,04146,SUB-DISTRICT,Malegaon,143,368137,191267,176870
27,516,04147,SUB-DISTRICT,Nandgaon,100,185186,96561,88625
27,516,04148,SUB-DISTRICT,Chandvad,111,210508,108814,101694
27,516,04149,SUB-DISTRICT,Dindori,157,315709,161500,154209
27,516,04150,SUB-DISTRICT,Peint,145,119838,60292,59546
27,516,04151,SUB-DISTRICT,Trimbakeshwar,125,156367,79128,77239
27,516,04152,SUB-DISTRICT,Nashik,73,175948,90889,85059
27,516,04153,SUB-DISTRICT,Igatpuri,117,197686,100466,97220
27,516,04154,SUB-DISTRICT,Sinnar,129,281091,145368,135723
27,516,04155,SUB-DISTRICT,Niphad,134,418853,216293,202560
27,516,04156,SUB-DISTRICT,Yevla,124,221320,114408,106912
27,517,00000,DISTRICT,Thane,1704,2545470,1300136,1245334
27,517,04157,SUB-DISTRICT,Talasari,46,154818,76417,78401
27,517,04158,SUB-DISTRICT,Dahanu,173,338162,166991,171171
27,517,04159,SUB-DISTRICT,Vikramgad,93,131634,65409,66225
27,517,04160,SUB-DISTRICT,Jawhar,108,128147,63206,64941
27,517,04161,SUB-DISTRICT,Mokhada,59,83453,41691,41762
27,517,04162,SUB-DISTRICT,Vada,168,154416,79495,74921
27,517,04163,SUB-DISTRICT,Palghar,200,324786,165149,159637
27,517,04164,SUB-DISTRICT,Vasai,50,113262,57562,55700
27,517,04165,SUB-DISTRICT,Thane,14,15623,8230,7393
27,517,04166,SUB-DISTRICT,Bhiwandi,210,277646,146946,130700
27,517,04167,SUB-DISTRICT,Shahapur,221,243393,123721,119672
27,517,04168,SUB-DISTRICT,Kalyan,85,283192,152274,130918
27,517,04169,SUB-DISTRICT,Ulhasnagar,0,0,0,0
27,517,04170,SUB-DISTRICT,Ambarnath,71,125011,65804,59207
27,517,04171,SUB-DISTRICT,Murbad,206,171927,87241,84686
27,518,00000,DISTRICT,Mumbai Suburban,0,0,0,0
27,519,00000,DISTRICT,Mumbai,0,0,0,0
27,520,00000,DISTRICT,Raigarh,1860,1664005,836996,827009
27,520,04172,SUB-DISTRICT,Uran,53,90828,46531,44297
27,520,04173,SUB-DISTRICT,Panvel,157,252477,133230,119247
27,520,04174,SUB-DISTRICT,Karjat,176,159566,81132,78434
27,520,04175,SUB-DISTRICT,Khalapur,120,111500,58721,52779
27,520,04176,SUB-DISTRICT,Pen,151,148824,75700,73124
27,520,04177,SUB-DISTRICT,Alibag,193,194481,97890,96591
27,520,04178,SUB-DISTRICT,Murud,72,61991,30401,31590
27,520,04179,SUB-DISTRICT,Roha,167,119775,60993,58782
27,520,04180,SUB-DISTRICT,Sudhagad,97,53204,26850,26354
27,520,04181,SUB-DISTRICT,Mangaon,185,141078,69537,71541
27,520,04182,SUB-DISTRICT,Tala,63,40619,19244,21375
27,520,04183,SUB-DISTRICT,Shrivardhan,78,60952,27774,33178
27,520,04184,SUB-DISTRICT,Mhasla,81,50235,22899,27336
27,520,04185,SUB-DISTRICT,Mahad,181,138955,67490,71465
27,520,04186,SUB-DISTRICT,Poladpur,86,39520,18604,20916
27,521,00000,DISTRICT,Pune,1852,3678226,1903440,1774786
27,521,04187,SUB-DISTRICT,Junnar,181,373987,189294,184693
27,521,04188,SUB-DISTRICT,Ambegaon,143,217096,109583,107513
27,521,04189,SUB-DISTRICT,Shirur,115,321644,167526,154118
27,521,04190,SUB-DISTRICT,Khed,185,320782,167045,153737
27,521,04191,SUB-DISTRICT,Mawal,181,219784,115137,104647
27,521,04192,SUB-DISTRICT,Mulshi,143,145373,76032,69341
27,521,04193,SUB-DISTRICT,Haveli,118,611631,322760,288871
27,521,04194,SUB-DISTRICT,Pune City,1,29965,16309,13656
27,521,04195,SUB-DISTRICT,Daund,102,324183,167717,156466
27,521,04196,SUB-DISTRICT,Purandhar,107,178095,90638,87457
27,521,04197,SUB-DISTRICT,Velhe,124,54516,27504,27012
27,521,04198,SUB-DISTRICT,Bhor,194,167663,84902,82761
27,521,04199,SUB-DISTRICT,Baramati,116,355839,183444,172395
27,521,04200,SUB-DISTRICT,Indapur,142,357668,185549,172119
27,522,00000,DISTRICT,Ahmadnagar,1581,3630542,1872907,1757635
27,522,04201,SUB-DISTRICT,Akola,190,281904,142642,139262
27,522,04202,SUB-DISTRICT,Sangamner,170,400275,206146,194129
27,522,04203,SUB-DISTRICT,Kopargaon,80,237179,122516,114663
27,522,04204,SUB-DISTRICT,Rahta,58,262146,134978,127168
27,522,04205,SUB-DISTRICT,Shrirampur,55,198218,101668,96550
27,522,04206,SUB-DISTRICT,Nevasa,129,357829,185001,172828
27,522,04207,SUB-DISTRICT,Shevgaon,112,245714,125837,119877
27,522,04208,SUB-DISTRICT,Pathardi,134,230898,119817,111081
27,522,04209,SUB-DISTRICT,Nagar,106,255862,132661,123201
27,522,04210,SUB-DISTRICT,Rahuri,96,253013,130828,122185
27,522,04211,SUB-DISTRICT,Parner,131,274167,140267,133900
27,522,04212,SUB-DISTRICT,Shrigonda,114,284841,148296,136545
27,522,04213,SUB-DISTRICT,Karjat,120,224133,117177,106956
27,522,04214,SUB-DISTRICT,Jamkhed,86,124363,65073,59290
27,523,00000,DISTRICT,Bid,1357,2070751,1082978,987773
27,523,04215,SUB-DISTRICT,Ashti,176,231635,120459,111176
27,523,04216,SUB-DISTRICT,Patoda,105,125081,65854,59227
27,523,04217,SUB-DISTRICT,Shirur (Kasar),94,128583,67626,60957
27,523,04218,SUB-DISTRICT,Georai,193,305048,159044,146004
27,523,04219,SUB-DISTRICT,Manjlegaon,121,205728,107291,98437
27,523,04220,SUB-DISTRICT,Wadwani,45,87685,45866,41819
27,523,04221,SUB-DISTRICT,Bid,224,277955,146256,131699
27,523,04222,SUB-DISTRICT,Kaij,121,213128,111999,101129
27,523,04223,SUB-DISTRICT,Dharur,67,101693,53285,48408
27,523,04224,SUB-DISTRICT,Parli,105,196233,102446,93787
27,523,04225,SUB-DISTRICT,Ambejogai,106,197982,102852,95130
27,524,00000,DISTRICT,Latur,928,1829216,949707,879509
27,524,04226,SUB-DISTRICT,Latur,120,286711,150704,136007
27,524,04227,SUB-DISTRICT,Renapur,79,142187,74023,68164
27,524,04228,SUB-DISTRICT,Ahmadpur,123,192232,99921,92311
27,524,04229,SUB-DISTRICT,Jalkot,47,87201,45058,42143
27,524,04230,SUB-DISTRICT,Chakur,83,177956,92262,85694
27,524,04231,SUB-DISTRICT,Shirur-Anantpal,48,83528,42904,40624
27,524,04232,SUB-DISTRICT,Ausa,126,273453,142244,131209
27,524,04233,SUB-DISTRICT,Nilanga,152,289083,149230,139853
27,524,04234,SUB-DISTRICT,Deoni,53,97598,50150,47448
27,524,04235,SUB-DISTRICT,Udgir,97,199267,103211,96056
27,525,00000,DISTRICT,Osmanabad,728,1376519,716237,660282
27,525,04236,SUB-DISTRICT,Paranda,95,121390,64023,57367
27,525,04237,SUB-DISTRICT,Bhum,95,118184,62100,56084
27,525,04238,SUB-DISTRICT,Washi,54,92150,48076,44074
27,525,04239,SUB-DISTRICT,Kalamb,94,191974,100238,91736
27,525,04240,SUB-DISTRICT,Osmanabad,124,293911,152976,140935
27,525,04241,SUB-DISTRICT,Tuljapur,123,226527,117793,108734
27,525,04242,SUB-DISTRICT,Lohara,47,116712,60258,56454
27,525,04243,SUB-DISTRICT,Umarga,96,215671,110773,104898
27,526,00000,DISTRICT,Solapur,1143,2918665,1518343,1400322
27,526,04244,SUB-DISTRICT,Karmala,122,231290,120795,110495
27,526,04245,SUB-DISTRICT,Madha,116,301564,157947,143617
27,526,04246,SUB-DISTRICT,Barshi,137,253989,132976,121013
27,526,04247,SUB-DISTRICT,Solapur North,40,105794,55267,50527
27,526,04248,SUB-DISTRICT,Mohol,102,276920,144299,132621
27,526,04249,SUB-DISTRICT,Pandharpur,100,343445,179714,163731
27,526,04250,SUB-DISTRICT,Malshiras,114,421244,218793,202451
27,526,04251,SUB-DISTRICT,Sangole,102,288524,149034,139490
27,526,04252,SUB-DISTRICT,Mangalvedhe,81,184108,96045,88063
27,526,04253,SUB-DISTRICT,Solapur South,91,260897,134206,126691
27,526,04254,SUB-DISTRICT,Akkalkot,138,250890,129267,121623
27,527,00000,DISTRICT,Satara,1719,2433363,1219749,1213614
27,527,04255,SUB-DISTRICT,Mahabaleshwar,110,44543,22291,22252
27,527,04256,SUB-DISTRICT,Wai,126,163453,81313,82140
27,527,04257,SUB-DISTRICT,Khandala,65,118695,61005,57690
27,527,04258,SUB-DISTRICT,Phaltan,125,282495,145855,136640
27,527,04259,SUB-DISTRICT,Man,104,201514,102017,99497
27,527,04260,SUB-DISTRICT,Khatav,139,275274,136802,138472
27,527,04261,SUB-DISTRICT,Koregaon,138,215177,107343,107834
27,527,04262,SUB-DISTRICT,Satara,205,289825,145454,144371
27,527,04263,SUB-DISTRICT,Jaoli,153,101828,49181,52647
27,527,04264,SUB-DISTRICT,Patan,338,285730,138112,147618
27,527,04265,SUB-DISTRICT,Karad,216,454829,230376,224453
27,528,00000,DISTRICT,Ratnagiri,1531,1351346,630213,721133
27,528,04266,SUB-DISTRICT,Mandangad,109,62123,27990,34133
27,528,04267,SUB-DISTRICT,Dapoli,172,144084,65656,78428
27,528,04268,SUB-DISTRICT,Khed,215,164723,78334,86389
27,528,04269,SUB-DISTRICT,Chiplun,164,211586,100997,110589
27,528,04270,SUB-DISTRICT,Guhagar,121,121588,53873,67715
27,528,04271,SUB-DISTRICT,Ratnagiri,196,212850,102847,110003
27,528,04272,SUB-DISTRICT,Sangameshwar,197,185654,86549,99105
27,528,04273,SUB-DISTRICT,Lanja,121,92609,42812,49797
27,528,04274,SUB-DISTRICT,Rajapur,236,156129,71155,84974
27,529,00000,DISTRICT,Sindhudurg,740,742645,363268,379377
27,529,04275,SUB-DISTRICT,Devgad,98,120909,58938,61971
27,529,04276,SUB-DISTRICT,Vaibhavvadi,59,43845,20563,23282
27,529,04277,SUB-DISTRICT,Kankavli,105,110886,53835,57051
27,529,04278,SUB-DISTRICT,Malwan,134,93159,45347,47812
27,529,04279,SUB-DISTRICT,Vengurla,83,73409,36039,37370
27,529,04280,SUB-DISTRICT,Kudal,124,139609,69088,70521
27,529,04281,SUB-DISTRICT,Sawantwadi,82,111924,55216,56708
27,529,04282,SUB-DISTRICT,Dodamarg,55,48904,24242,24662
27,530,00000,DISTRICT,Kolhapur,1195,2645992,1348815,1297177
27,530,04283,SUB-DISTRICT,Shahuwadi,133,180322,89170,91152
27,530,04284,SUB-DISTRICT,Panhala,129,251603,131472,120131
27,530,04285,SUB-DISTRICT,Hatkanangle,58,407228,210277,196951
27,530,04286,SUB-DISTRICT,Shirol,54,320133,164223,155910
27,530,04287,SUB-DISTRICT,Karvir,121,382004,199832,182172
27,530,04288,SUB-DISTRICT,Bavda,45,35772,18467,17305
27,530,04289,SUB-DISTRICT,Radhanagari,114,199713,103190,96523
27,530,04290,SUB-DISTRICT,Kagal,84,230072,117947,112125
27,530,04291,SUB-DISTRICT,Bhudargad,114,150368,75824,74544
27,530,04292,SUB-DISTRICT,Ajra,97,103008,48568,54440
27,530,04293,SUB-DISTRICT,Gadhinglaj,90,198549,97109,101440
27,530,04294,SUB-DISTRICT,Chandgad,156,187220,92736,94484
27,531,00000,DISTRICT,Sangli,725,2102786,1071124,1031662
27,531,04295,SUB-DISTRICT,Shirala,95,162911,80838,82073
27,531,04296,SUB-DISTRICT,Walwa,96,351506,181554,169952
27,531,04297,SUB-DISTRICT,Palus,35,164909,85298,79611
27,531,04298,SUB-DISTRICT,Kadegaon,56,143019,71768,71251
27,531,04299,SUB-DISTRICT,Khanapur,66,121925,59931,61994
27,531,04300,SUB-DISTRICT,Atpadi,60,138455,69410,69045
27,531,04301,SUB-DISTRICT,Tasgaon,68,213456,108687,104769
27,531,04302,SUB-DISTRICT,Miraj,64,325954,167767,158187
27,531,04303,SUB-DISTRICT,Kavathemahankal,60,152327,77615,74712
27,531,04304,SUB-DISTRICT,Jat,125,328324,168256,160068
28,000,00000,STATE,ANDHRA PRADESH,26286,56361702,28243241,28118461
28,532,00000,DISTRICT,Adilabad,1590,1980980,985303,995677
28,532,04305,SUB-DISTRICT,Tamsi,31,39631,19615,20016
28,532,04306,SUB-DISTRICT,Adilabad,38,58955,29292,29663
28,532,04307,SUB-DISTRICT,Jainad,46,47904,23797,24107
28,532,04308,SUB-DISTRICT,Bela,41,38318,19942,18376
28,532,04309,SUB-DISTRICT,Talamadugu,27,34632,17227,17405
28,532,04310,SUB-DISTRICT,Gudihathnoor,21,30339,15185,15154
28,532,04311,SUB-DISTRICT,Inderavelly,34,47506,23592,23914
28,532,04312,SUB-DISTRICT,Narnoor,54,49239,25789,23450
28,532,04313,SUB-DISTRICT,Kerameri ,43,30724,15466,15258
28,532,04314,SUB-DISTRICT,Wankdi,35,35523,17724,17799
28,532,04315,SUB-DISTRICT,Sirpur (T),23,31130,15607,15523
28,532,04316,SUB-DISTRICT,Kouthala,28,50938,25638,25300
28,532,04317,SUB-DISTRICT,Bejjur,44,49284,24330,24954
28,532,04318,SUB-DISTRICT,Kagaznagar,35,52495,26519,25976
28,532,04319,SUB-DISTRICT,Asifabad ,51,35452,17827,17625
28,532,04320,SUB-DISTRICT,Jainoor,17,25111,12550,12561
28,532,04321,SUB-DISTRICT,Utnoor,37,47460,24510,22950
28,532,04322,SUB-DISTRICT,Ichoda,41,40482,20062,20420
28,532,04323,SUB-DISTRICT,Bazarhathnoor,28,28911,14546,14365
28,532,04324,SUB-DISTRICT,Boath,35,48216,23589,24627
28,532,04325,SUB-DISTRICT,Neradigonda,39,29633,14448,15185
28,532,04326,SUB-DISTRICT,Sirpur,26,26097,12972,13125
28,532,04327,SUB-DISTRICT,Rebbana,27,35859,18513,17346
28,532,04328,SUB-DISTRICT,Bhimini,30,26285,13225,13060
28,532,04329,SUB-DISTRICT,Dahegaon,38,34712,17131,17581
28,532,04330,SUB-DISTRICT,Vemanpalle,26,19532,9809,9723
28,532,04331,SUB-DISTRICT,Nennal,21,23534,11722,11812
28,532,04332,SUB-DISTRICT,Tandur,20,32617,16393,16224
28,532,04333,SUB-DISTRICT,Tiryani,37,26410,13129,13281
28,532,04334,SUB-DISTRICT,Jannaram,25,52883,26235,26648
28,532,04335,SUB-DISTRICT,Kaddam (Peddur),38,52703,25937,26766
28,532,04336,SUB-DISTRICT,Sarangapur,26,48820,22936,25884
28,532,04337,SUB-DISTRICT,Kuntala,26,34190,16674,17516
28,532,04338,SUB-DISTRICT,Kubeer,38,47984,23773,24211
28,532,04339,SUB-DISTRICT,Bhainsa,32,39653,19330,20323
28,532,04340,SUB-DISTRICT,Tanoor,31,39752,19852,19900
28,532,04341,SUB-DISTRICT,Mudhole,33,55923,27401,28522
28,532,04342,SUB-DISTRICT,Lokeswaram,26,34253,16309,17944
28,532,04343,SUB-DISTRICT,Dilawarpur,24,35780,17130,18650
28,532,04344,SUB-DISTRICT,Nirmal,33,51137,24221,26916
28,532,04345,SUB-DISTRICT,Laxmanchanda,22,36739,17515,19224
28,532,04346,SUB-DISTRICT,Mamda,29,32303,15570,16733
28,532,04347,SUB-DISTRICT,Khanapur,31,48499,24120,24379
28,532,04348,SUB-DISTRICT,Dandepalle,30,49741,24794,24947
28,532,04349,SUB-DISTRICT,Kasipet,19,16050,8114,7936
28,532,04350,SUB-DISTRICT,Bellampalle,12,26939,14134,12805
28,532,04351,SUB-DISTRICT,Kotapalle,34,33110,17034,16076
28,532,04352,SUB-DISTRICT,Mandamarri,8,15372,7743,7629
28,532,04353,SUB-DISTRICT,Luxettipet,20,39352,19874,19478
28,532,04354,SUB-DISTRICT,Mancherial,19,31676,15798,15878
28,532,04355,SUB-DISTRICT,Jaipur,32,50079,25183,24896
28,532,04356,SUB-DISTRICT,Chennur,29,31113,15477,15636
28,533,00000,DISTRICT,Nizamabad,847,1962963,958837,1004126
28,533,04357,SUB-DISTRICT,Ranjal,10,38880,19403,19477
28,533,04358,SUB-DISTRICT,Navipet,29,55125,27096,28029
28,533,04359,SUB-DISTRICT,Nandipet,30,70598,33754,36844
28,533,04360,SUB-DISTRICT,Armur,19,57964,28078,29886
28,533,04361,SUB-DISTRICT,Balkonda,21,74183,35745,38438
28,533,04362,SUB-DISTRICT,Mortad,17,56153,27185,28968
28,533,04363,SUB-DISTRICT,Kammarpalle,14,42765,20795,21970
28,533,04364,SUB-DISTRICT,Bheemgal,24,62666,30493,32173
28,533,04365,SUB-DISTRICT,Velpur,16,42486,20610,21876
28,533,04366,SUB-DISTRICT,Jakranpalle,16,45505,22034,23471
28,533,04367,SUB-DISTRICT,Makloor,22,58588,28060,30528
28,533,04368,SUB-DISTRICT,Nizamabad,34,101348,49771,51577
28,533,04369,SUB-DISTRICT,Yedpalle,10,40028,19494,20534
28,533,04370,SUB-DISTRICT,Bodhan,35,66176,32371,33805
28,533,04371,SUB-DISTRICT,Kotgiri,31,56917,27920,28997
28,533,04372,SUB-DISTRICT,Madnoor,38,59002,29957,29045
28,533,04373,SUB-DISTRICT,Jukkal,33,53980,27552,26428
28,533,04374,SUB-DISTRICT,Bichkunda,35,64044,31970,32074
28,533,04375,SUB-DISTRICT,Birkoor,24,50391,24550,25841
28,533,04376,SUB-DISTRICT,Varni,26,72230,35311,36919
28,533,04377,SUB-DISTRICT,Dichpalle,19,71714,34817,36897
28,533,04378,SUB-DISTRICT,Dharpalle,14,47954,22936,25018
28,533,04379,SUB-DISTRICT,Sirkonda,21,51078,24673,26405
28,533,04380,SUB-DISTRICT,Machareddy,24,58443,28425,30018
28,533,04381,SUB-DISTRICT,Sadasivanagar,27,56005,27362,28643
28,533,04382,SUB-DISTRICT,Gandhari,34,58535,29435,29100
28,533,04383,SUB-DISTRICT,Banswada,16,40348,19406,20942
28,533,04384,SUB-DISTRICT,Pitlam,27,47581,23443,24138
28,533,04385,SUB-DISTRICT,Nizamsagar,26,36913,17889,19024
28,533,04386,SUB-DISTRICT,Yellareddy,28,31330,15055,16275
28,533,04387,SUB-DISTRICT,Nagareddipet,22,34601,16600,18001
28,533,04388,SUB-DISTRICT,Lingampet,23,48122,23405,24717
28,533,04389,SUB-DISTRICT,Tadwai,22,48585,23395,25190
28,533,04390,SUB-DISTRICT,Kamareddy,21,46130,22690,23440
28,533,04391,SUB-DISTRICT,Bhiknoor,19,59656,29157,30499
28,533,04392,SUB-DISTRICT,Domakonda,20,56939,28000,28939
28,534,00000,DISTRICT,Karimnagar,1037,2825044,1401950,1423094
28,534,04393,SUB-DISTRICT,Ibrahimpatnam,18,52759,25569,27190
28,534,04394,SUB-DISTRICT,Mallapur,19,53870,26080,27790
28,534,04395,SUB-DISTRICT,Raikal,20,63907,31140,32767
28,534,04396,SUB-DISTRICT,Sarangapur,25,45006,21909,23097
28,534,04397,SUB-DISTRICT,Dharmapuri,23,78365,38285,40080
28,534,04398,SUB-DISTRICT,Velgatoor,24,51719,25824,25895
28,534,04399,SUB-DISTRICT,Ramagundam,17,32102,16060,16042
28,534,04400,SUB-DISTRICT,Kamanpur,19,57169,28918,28251
28,534,04401,SUB-DISTRICT,Manthani,31,54669,27141,27528
28,534,04402,SUB-DISTRICT,Kataram,28,37336,18617,18719
28,534,04403,SUB-DISTRICT,Mahadevpur,37,38489,18986,19503
28,534,04404,SUB-DISTRICT,Mutharam (Mahadevpur),21,26312,13187,13125
28,534,04405,SUB-DISTRICT,Malharrao,17,25343,12685,12658
28,534,04406,SUB-DISTRICT,Mutharam (Manthani),18,31567,15653,15914
28,534,04407,SUB-DISTRICT,Srirampur,17,41956,21125,20831
28,534,04408,SUB-DISTRICT,Peddapalle,21,60605,30119,30486
28,534,04409,SUB-DISTRICT,Julapalle,6,27661,13705,13956
28,534,04410,SUB-DISTRICT,Elgaid,9,22342,11127,11215
28,534,04411,SUB-DISTRICT,Dharmaram,17,54087,27035,27052
28,534,04412,SUB-DISTRICT,Gollapalle,22,44951,22029,22922
28,534,04413,SUB-DISTRICT,Mallial,15,47373,23125,24248
28,534,04414,SUB-DISTRICT,Jagtial,24,65134,32059,33075
28,534,04415,SUB-DISTRICT,Medipalle,19,51209,25268,25941
28,534,04416,SUB-DISTRICT,Koratla,14,41842,20474,21368
28,534,04417,SUB-DISTRICT,Metpalle,13,35790,17416,18374
28,534,04418,SUB-DISTRICT,Kathlapur,18,43986,20891,23095
28,534,04419,SUB-DISTRICT,Chandurthi,12,43596,21694,21902
28,534,04420,SUB-DISTRICT,Kodimial,15,43685,21358,22327
28,534,04421,SUB-DISTRICT,Pegadapalle,16,47981,23839,24142
28,534,04422,SUB-DISTRICT,Gangadhara,19,49251,24538,24713
28,534,04423,SUB-DISTRICT,Ramadugu,18,48253,23985,24268
28,534,04424,SUB-DISTRICT,Choppadandi,12,51288,25813,25475
28,534,04425,SUB-DISTRICT,Sultanabad,21,63454,31465,31989
28,534,04426,SUB-DISTRICT,Odela,11,42211,20964,21247
28,534,04427,SUB-DISTRICT,Manakondur,18,67854,33999,33855
28,534,04428,SUB-DISTRICT,Karimnagar,23,71823,35757,36066
28,534,04429,SUB-DISTRICT,Boinpalle,16,39240,19569,19671
28,534,04430,SUB-DISTRICT,Vemulawada,22,46769,23475,23294
28,534,04431,SUB-DISTRICT,Konaraopeta,19,40857,19873,20984
28,534,04432,SUB-DISTRICT,Yellareddipet,22,59633,29750,29883
28,534,04433,SUB-DISTRICT,Gambhiraopet,17,46878,23064,23814
28,534,04434,SUB-DISTRICT,Mustabad,15,44217,22046,22171
28,534,04435,SUB-DISTRICT,Sircilla,21,59490,29270,30220
28,534,04436,SUB-DISTRICT,Ellanthakunta,22,51278,25556,25722
28,534,04437,SUB-DISTRICT,Bejjanki,23,53945,26930,27015
28,534,04438,SUB-DISTRICT,Timmapur (LMD Colony),13,42862,21064,21798
28,534,04439,SUB-DISTRICT,Veenavanka,14,49041,24389,24652
28,534,04440,SUB-DISTRICT,Jammikunta,18,91892,46626,45266
28,534,04441,SUB-DISTRICT,Shankarapatnam,17,45302,22689,22613
28,534,04442,SUB-DISTRICT,Chigurumamidi,11,41859,20984,20875
28,534,04443,SUB-DISTRICT,Koheda,16,44645,22334,22311
28,534,04444,SUB-DISTRICT,Husnabad,24,78793,39593,39200
28,534,04445,SUB-DISTRICT,Saidapur,14,40801,20394,20407
28,534,04446,SUB-DISTRICT,Huzurabad,12,74721,37702,37019
28,534,04447,SUB-DISTRICT,Kamalapur,16,61413,31104,30309
28,534,04448,SUB-DISTRICT,Bheemadevarpalle,15,55886,27899,27987
28,534,04449,SUB-DISTRICT,Elkathurthi,13,40577,19800,20777
28,535,00000,DISTRICT,Medak,1201,2305417,1152806,1152611
28,535,04450,SUB-DISTRICT,Kangti,32,52573,26818,25755
28,535,04451,SUB-DISTRICT,Manoor,45,59501,30387,29114
28,535,04452,SUB-DISTRICT,Narayankhed,35,66517,33612,32905
28,535,04453,SUB-DISTRICT,Kalher,24,51486,26024,25462
28,535,04454,SUB-DISTRICT,Shankarampet (A),22,34926,17319,17607
28,535,04455,SUB-DISTRICT,Papannapet,26,57149,27767,29382
28,535,04456,SUB-DISTRICT,Medak,35,68297,33148,35149
28,535,04457,SUB-DISTRICT,Ramayampet,24,68846,33962,34884
28,535,04458,SUB-DISTRICT,Dubbak,25,71847,35324,36523
28,535,04459,SUB-DISTRICT,Siddipet,21,58787,29071,29716
28,535,04460,SUB-DISTRICT,Chinnakodur,23,58271,28974,29297
28,535,04461,SUB-DISTRICT,Nangnoor,21,41794,20995,20799
28,535,04462,SUB-DISTRICT,Kondapak,21,48592,24216,24376
28,535,04463,SUB-DISTRICT,Thoguta,16,34488,17005,17483
28,535,04464,SUB-DISTRICT,Mirdoddi,17,42002,20637,21365
28,535,04465,SUB-DISTRICT,Doultabad,30,53824,26783,27041
28,535,04466,SUB-DISTRICT,Chegunta,28,53118,26127,26991
28,535,04467,SUB-DISTRICT,Shankarampet (R),20,44994,22098,22896
28,535,04468,SUB-DISTRICT,Kulcharam,21,35910,17509,18401
28,535,04469,SUB-DISTRICT,Tekmal,20,37879,18639,19240
28,535,04470,SUB-DISTRICT,Alladurg,20,47678,23745,23933
28,535,04471,SUB-DISTRICT,Regode,25,36167,18362,17805
28,535,04472,SUB-DISTRICT,Raikode,33,40732,20871,19861
28,535,04473,SUB-DISTRICT,Nyalkal,39,57110,28848,28262
28,535,04474,SUB-DISTRICT,Zahirabad,32,87009,44007,43002
28,535,04475,SUB-DISTRICT,Kohir,23,60638,30462,30176
28,535,04476,SUB-DISTRICT,Jharasangam,34,44583,22731,21852
28,535,04477,SUB-DISTRICT,Munpalle,30,40965,20661,20304
28,535,04478,SUB-DISTRICT,Pulkal,28,51386,25737,25649
28,535,04479,SUB-DISTRICT,Andole,26,45042,22017,23025
28,535,04480,SUB-DISTRICT,Kowdipalle,34,55518,27442,28076
28,535,04481,SUB-DISTRICT,Yeldurthy,22,42309,20842,21467
28,535,04482,SUB-DISTRICT,Tupran,33,60580,30333,30247
28,535,04483,SUB-DISTRICT,Gajwel,24,52303,26111,26192
28,535,04484,SUB-DISTRICT,Jagdevpur,28,47093,23266,23827
28,535,04485,SUB-DISTRICT,Wargal,22,44525,22540,21985
28,535,04486,SUB-DISTRICT,Mulug,27,44076,22168,21908
28,535,04487,SUB-DISTRICT,Shivampet,27,45132,22505,22627
28,535,04488,SUB-DISTRICT,Narsapur,33,53774,27297,26477
28,535,04489,SUB-DISTRICT,Hathnoora,32,55935,28554,27381
28,535,04490,SUB-DISTRICT,Sadasivpet,26,46417,23318,23099
28,535,04491,SUB-DISTRICT,Kondapur,23,42985,21681,21304
28,535,04492,SUB-DISTRICT,Sangareddy,25,58961,29936,29025
28,535,04493,SUB-DISTRICT,Jinnaram,25,49164,25185,23979
28,535,04494,SUB-DISTRICT,Patancheru,19,44632,22625,22007
28,535,04495,SUB-DISTRICT,Ramachandrapuram,5,9902,5147,4755
28,536,00000,DISTRICT,Hyderabad,0,0,0,0
28,536,04496,SUB-DISTRICT,Shaikpet,0,0,0,0
28,536,04497,SUB-DISTRICT,Ameerpet,0,0,0,0
28,536,04498,SUB-DISTRICT,Secunderabad,0,0,0,0
28,536,04499,SUB-DISTRICT,Tirumalagiri,0,0,0,0
28,536,04500,SUB-DISTRICT,Maredpalle,0,0,0,0
28,536,04501,SUB-DISTRICT,Musheerabad,0,0,0,0
28,536,04502,SUB-DISTRICT,Amberpet,0,0,0,0
28,536,04503,SUB-DISTRICT,Himayathnagar,0,0,0,0
28,536,04504,SUB-DISTRICT,Nampally,0,0,0,0
28,536,04505,SUB-DISTRICT,Khairatabad,0,0,0,0
28,536,04506,SUB-DISTRICT,Asifnagar,0,0,0,0
28,536,04507,SUB-DISTRICT,Golconda,0,0,0,0
28,536,04508,SUB-DISTRICT,Bahadurpura,0,0,0,0
28,536,04509,SUB-DISTRICT,Bandlaguda,0,0,0,0
28,536,04510,SUB-DISTRICT,Charminar,0,0,0,0
28,536,04511,SUB-DISTRICT,Saidabad,0,0,0,0
28,537,00000,DISTRICT,Rangareddy,817,1577569,801013,776556
28,537,04512,SUB-DISTRICT,Marpalle,28,51090,25714,25376
28,537,04513,SUB-DISTRICT,Mominpet,23,43261,21651,21610
28,537,04514,SUB-DISTRICT,Nawabpet,22,41283,20983,20300
28,537,04515,SUB-DISTRICT,Shankarpalle,25,65428,33190,32238
28,537,04516,SUB-DISTRICT,Serilingampally,0,0,0,0
28,537,04517,SUB-DISTRICT,Balanagar,0,0,0,0
28,537,04518,SUB-DISTRICT,Qutubullapur,2,1431,718,713
28,537,04519,SUB-DISTRICT,Medchal,25,57814,29448,28366
28,537,04520,SUB-DISTRICT,Shamirpet,27,72610,37839,34771
28,537,04521,SUB-DISTRICT,Malkajgiri,0,0,0,0
28,537,04522,SUB-DISTRICT,Keesara,12,27456,14024,13432
28,537,04523,SUB-DISTRICT,Ghatkesar,15,50517,26522,23995
28,537,04524,SUB-DISTRICT,Uppal,0,0,0,0
28,537,04525,SUB-DISTRICT,Hayathnagar,20,51601,26434,25167
28,537,04526,SUB-DISTRICT,Saroornagar,0,0,0,0
28,537,04527,SUB-DISTRICT,Rajendranagar,12,24590,12487,12103
28,537,04528,SUB-DISTRICT,Moinabad,26,56205,29032,27173
28,537,04529,SUB-DISTRICT,Chevella,36,58166,29549,28617
28,537,04530,SUB-DISTRICT,Vicarabad,25,32267,16302,15965
28,537,04531,SUB-DISTRICT,Dharur,37,44900,22392,22508
28,537,04532,SUB-DISTRICT,Bantwaram,24,33159,16533,16626
28,537,04533,SUB-DISTRICT,Peddemul,29,51893,25725,26168
28,537,04534,SUB-DISTRICT,Tandur,34,53661,26789,26872
28,537,04535,SUB-DISTRICT,Basheerabad,28,36851,18210,18641
28,537,04536,SUB-DISTRICT,Yelal,33,45295,22128,23167
28,537,04537,SUB-DISTRICT,Doma,28,48224,24168,24056
28,537,04538,SUB-DISTRICT,Gandeed,28,70387,35062,35325
28,537,04539,SUB-DISTRICT,Kulkacharla,30,70281,35780,34501
28,537,04540,SUB-DISTRICT,Pargi,35,62984,31420,31564
28,537,04541,SUB-DISTRICT,Pudur,33,44884,22712,22172
28,537,04542,SUB-DISTRICT,Shabad,25,51334,26135,25199
28,537,04543,SUB-DISTRICT,Shamshabad,36,52731,26976,25755
28,537,04544,SUB-DISTRICT,Maheswaram,30,65125,33792,31333
28,537,04545,SUB-DISTRICT,Kandukur,27,54587,28076,26511
28,537,04546,SUB-DISTRICT,Ibrahimpatnam,22,61657,31909,29748
28,537,04547,SUB-DISTRICT,Manchal,21,46488,23879,22609
28,537,04548,SUB-DISTRICT,Yacharam,19,49409,25434,23975
28,538,00000,DISTRICT,Mahbubnagar,1465,3445336,1742438,1702898
28,538,04549,SUB-DISTRICT,Kodangal,19,53673,26545,27128
28,538,04550,SUB-DISTRICT,Bomraspet,25,55937,27858,28079
28,538,04551,SUB-DISTRICT,Kosgi,23,57495,28575,28920
28,538,04552,SUB-DISTRICT,Doulathabad,26,51497,25656,25841
28,538,04553,SUB-DISTRICT,Damaragidda,28,57946,28874,29072
28,538,04554,SUB-DISTRICT,Maddur,29,67395,33583,33812
28,538,04555,SUB-DISTRICT,Hanwada,18,55044,27690,27354
28,538,04556,SUB-DISTRICT,Nawabpet,26,52061,26310,25751
28,538,04557,SUB-DISTRICT,Balanagar,37,66668,33979,32689
28,538,04558,SUB-DISTRICT,Kondurg,36,60518,30534,29984
28,538,04559,SUB-DISTRICT,Farooqnagar,33,66958,34033,32925
28,538,04560,SUB-DISTRICT,Kothur,15,54722,28358,26364
28,538,04561,SUB-DISTRICT,Keshampet,20,42592,21715,20877
28,538,04562,SUB-DISTRICT,Talakondapalle,28,52835,27020,25815
28,538,04563,SUB-DISTRICT,Amangal,16,62034,32201,29833
28,538,04564,SUB-DISTRICT,Madgul,14,49133,25042,24091
28,538,04565,SUB-DISTRICT,Veldanda,19,46006,23276,22730
28,538,04566,SUB-DISTRICT,Midjil,28,52352,26259,26093
28,538,04567,SUB-DISTRICT,Jadcherla,27,52210,25828,26382
28,538,04568,SUB-DISTRICT,Mahbubnagar,15,38833,19398,19435
28,538,04569,SUB-DISTRICT,Koilkonda,36,66721,33816,32905
28,538,04570,SUB-DISTRICT,Narayanpet,21,56086,28072,28014
28,538,04571,SUB-DISTRICT,Utkoor,24,55885,27827,28058
28,538,04572,SUB-DISTRICT,Dhanwada,18,64039,31734,32305
28,538,04573,SUB-DISTRICT,Devarkadra,28,58385,29490,28895
28,538,04574,SUB-DISTRICT,Bhoothpur,17,49777,25144,24633
28,538,04575,SUB-DISTRICT,Thimmajipet,17,40424,20271,20153
28,538,04576,SUB-DISTRICT,Kalwakurthy,17,36035,18329,17706
28,538,04577,SUB-DISTRICT,Vangoor,23,50113,25511,24602
28,538,04578,SUB-DISTRICT,Amrabad,14,45589,22607,22982
28,538,04579,SUB-DISTRICT,Achampet,20,41450,21178,20272
28,538,04580,SUB-DISTRICT,Uppununthala,20,34225,17208,17017
28,538,04581,SUB-DISTRICT,Telkapalle,20,49585,24951,24634
28,538,04582,SUB-DISTRICT,Tadoor,23,38375,19311,19064
28,538,04583,SUB-DISTRICT,Nagarkurnool,21,47927,24185,23742
28,538,04584,SUB-DISTRICT,Bijinapalle,24,72647,36705,35942
28,538,04585,SUB-DISTRICT,Ghanpur,21,48771,24991,23780
28,538,04586,SUB-DISTRICT,Addakal,21,52381,26462,25919
28,538,04587,SUB-DISTRICT,Chinnachintakunta,22,44704,22118,22586
28,538,04588,SUB-DISTRICT,Narva,30,49359,24500,24859
28,538,04589,SUB-DISTRICT,Makthal,36,72028,36094,35934
28,538,04590,SUB-DISTRICT,Maganoor,30,47957,23851,24106
28,538,04591,SUB-DISTRICT,Dharur,25,65945,33070,32875
28,538,04592,SUB-DISTRICT,Atmakur,24,49208,24665,24543
28,538,04593,SUB-DISTRICT,Kothakota,32,60562,30756,29806
28,538,04594,SUB-DISTRICT,Peddamandadi,15,40303,20386,19917
28,538,04595,SUB-DISTRICT,Wanaparthy,20,47572,24404,23168
28,538,04596,SUB-DISTRICT,Gopalpeta,20,59345,30120,29225
28,538,04597,SUB-DISTRICT,Balmoor,19,38768,20097,18671
28,538,04598,SUB-DISTRICT,Lingal,16,34979,18055,16924
28,538,04599,SUB-DISTRICT,Peddakothapalle,23,56461,28853,27608
28,538,04600,SUB-DISTRICT,Kodair,19,44986,23143,21843
28,538,04601,SUB-DISTRICT,Pangal,27,60254,31269,28985
28,538,04602,SUB-DISTRICT,Pebbair,27,68690,35061,33629
28,538,04603,SUB-DISTRICT,Gadwal,18,51213,26090,25123
28,538,04604,SUB-DISTRICT,Maldakal,19,52579,26593,25986
28,538,04605,SUB-DISTRICT,Ghattu,22,72977,36480,36497
28,538,04606,SUB-DISTRICT,Ieej,18,85303,43192,42111
28,538,04607,SUB-DISTRICT,Itikyal,21,52926,27308,25618
28,538,04608,SUB-DISTRICT,Veepangandla,25,51336,26338,24998
28,538,04609,SUB-DISTRICT,Kollapur,24,67687,34863,32824
28,538,04610,SUB-DISTRICT,Waddepalle,20,69445,35293,34152
28,538,04611,SUB-DISTRICT,Manopad,25,51543,26132,25411
28,538,04612,SUB-DISTRICT,Alampur,21,44882,23181,21701
28,539,00000,DISTRICT,Nalgonda,1107,2826302,1427716,1398586
28,539,04613,SUB-DISTRICT,Bommalaramaram,23,37248,18777,18471
28,539,04614,SUB-DISTRICT,M.Turkapalle,21,33797,17014,16783
28,539,04615,SUB-DISTRICT,Rajapet,18,34446,17565,16881
28,539,04616,SUB-DISTRICT,Yadagirigutta,15,39259,19566,19693
28,539,04617,SUB-DISTRICT,Alair,14,47365,23599,23766
28,539,04618,SUB-DISTRICT,Gundala,20,36190,18204,17986
28,539,04619,SUB-DISTRICT,Thirumalgiri,16,47657,24106,23551
28,539,04620,SUB-DISTRICT,Thungathurthi,20,57905,28679,29226
28,539,04621,SUB-DISTRICT,Nuthankal,21,56991,28833,28158
28,539,04622,SUB-DISTRICT,Atmakur (S),19,50970,25693,25277
28,539,04623,SUB-DISTRICT,Jaji Reddi Gudem,14,40785,20463,20322
28,539,04624,SUB-DISTRICT,Sali Gouraram,19,47075,23616,23459
28,539,04625,SUB-DISTRICT,Mothkur,23,55694,27911,27783
28,539,04626,SUB-DISTRICT,Atmakur (M),20,39194,19898,19296
28,539,04627,SUB-DISTRICT,Valigonda,27,56098,28596,27502
28,539,04628,SUB-DISTRICT,Bhongir,26,50199,25647,24552
28,539,04629,SUB-DISTRICT,Bibinagar,24,40178,20380,19798
28,539,04630,SUB-DISTRICT,Pochampalle,22,38089,19850,18239
28,539,04631,SUB-DISTRICT,Choutuppal,16,54244,27715,26529
28,539,04632,SUB-DISTRICT,Ramannapeta,20,41332,20497,20835
28,539,04633,SUB-DISTRICT,Chityala,15,41848,21434,20414
28,539,04634,SUB-DISTRICT,Narketpalle,19,50864,25916,24948
28,539,04635,SUB-DISTRICT,Kattangoor,18,46831,23577,23254
28,539,04636,SUB-DISTRICT,Nakrekal,15,31632,15981,15651
28,539,04637,SUB-DISTRICT,Kethe Palle,13,37533,18836,18697
28,539,04638,SUB-DISTRICT,Suryapet,15,48617,24299,24318
28,539,04639,SUB-DISTRICT,Chivvemla,15,47835,23948,23887
28,539,04640,SUB-DISTRICT,Mothey,15,44132,22212,21920
28,539,04641,SUB-DISTRICT,Nadigudem,16,39335,19558,19777
28,539,04642,SUB-DISTRICT,Munagala,11,43824,22326,21498
28,539,04643,SUB-DISTRICT,Penpahad,16,39624,19999,19625
28,539,04644,SUB-DISTRICT,Vemulapalle,23,44539,22328,22211
28,539,04645,SUB-DISTRICT,Thipparthi,19,47788,24123,23665
28,539,04646,SUB-DISTRICT,Nalgonda,23,45741,22899,22842
28,539,04647,SUB-DISTRICT,Munugode,21,45477,23396,22081
28,539,04648,SUB-DISTRICT,Narayanapur,14,44335,22877,21458
28,539,04649,SUB-DISTRICT,Marriguda,17,36968,18784,18184
28,539,04650,SUB-DISTRICT,Chintha Palle,22,45058,22757,22301
28,539,04651,SUB-DISTRICT,Gundla Palle,19,46380,23168,23212
28,539,04652,SUB-DISTRICT,Chandam Pet,23,51408,26787,24621
28,539,04653,SUB-DISTRICT,Devarakonda,26,59970,30522,29448
28,539,04654,SUB-DISTRICT,Nampalle,28,41247,20763,20484
28,539,04655,SUB-DISTRICT,Chandur,16,37986,19373,18613
28,539,04656,SUB-DISTRICT,Kangal,26,44029,22513,21516
28,539,04657,SUB-DISTRICT,Gurrampode,27,43280,21824,21456
28,539,04658,SUB-DISTRICT,Pedda Adiserla Palle,22,50338,25771,24567
28,539,04659,SUB-DISTRICT,Peddavoora,23,52072,26570,25502
28,539,04660,SUB-DISTRICT,Anumula,25,63740,32086,31654
28,539,04661,SUB-DISTRICT,Nidamanur,19,53816,27233,26583
28,539,04662,SUB-DISTRICT,Thripuraram,19,46627,23385,23242
28,539,04663,SUB-DISTRICT,Dameracherla,17,66946,33912,33034
28,539,04664,SUB-DISTRICT,Miryalaguda,23,70920,35875,35045
28,539,04665,SUB-DISTRICT,Neredcherla,27,66499,33388,33111
28,539,04666,SUB-DISTRICT,Garide Palle,11,56179,28135,28044
28,539,04667,SUB-DISTRICT,Chilkur,4,39225,19754,19471
28,539,04668,SUB-DISTRICT,Kodad,16,68896,34594,34302
28,539,04669,SUB-DISTRICT,Huzurnagar,7,60426,30177,30249
28,539,04670,SUB-DISTRICT,Mattam Palle,10,44939,22579,22360
28,539,04671,SUB-DISTRICT,Mella Cheruvu,14,74682,37448,37234
28,540,00000,DISTRICT,Warangal,961,2520243,1260594,1259649
28,540,04672,SUB-DISTRICT,Cherial,21,70809,35499,35310
28,540,04673,SUB-DISTRICT,Maddur,21,38731,19255,19476
28,540,04674,SUB-DISTRICT,Bachannapet,23,44265,22103,22162
28,540,04675,SUB-DISTRICT,Narmetta,16,42374,21083,21291
28,540,04676,SUB-DISTRICT,Ghanpur (Station),23,73340,36608,36732
28,540,04677,SUB-DISTRICT,Dharmasagar,18,70640,35128,35512
28,540,04678,SUB-DISTRICT,Hasanparthy,14,39389,19580,19809
28,540,04679,SUB-DISTRICT,Parkal,23,80542,40084,40458
28,540,04680,SUB-DISTRICT,Mogullapalle,19,39387,19614,19773
28,540,04681,SUB-DISTRICT,Chityal,32,61813,30518,31295
28,540,04682,SUB-DISTRICT,Bhupalpalle,18,44342,22045,22297
28,540,04683,SUB-DISTRICT,Ghanpur (Mulug),8,35952,17837,18115
28,540,04684,SUB-DISTRICT,Venkatapur,10,38959,19476,19483
28,540,04685,SUB-DISTRICT,Eturnagaram,42,41153,20312,20841
28,540,04686,SUB-DISTRICT,Mangapet,19,36927,18525,18402
28,540,04687,SUB-DISTRICT,Tadvai,41,22879,10893,11986
28,540,04688,SUB-DISTRICT,Govindaraopet,10,30738,15320,15418
28,540,04689,SUB-DISTRICT,Mulug,17,61741,31197,30544
28,540,04690,SUB-DISTRICT,Regonda,18,59602,29773,29829
28,540,04691,SUB-DISTRICT,Shayampet,13,40292,20066,20226
28,540,04692,SUB-DISTRICT,Nallabelly,19,37503,18923,18580
28,540,04693,SUB-DISTRICT,Duggondi,17,42050,20975,21075
28,540,04694,SUB-DISTRICT,Atmakur,22,59540,30063,29477
28,540,04695,SUB-DISTRICT,Hanamkonda,10,34505,17304,17201
28,540,04696,SUB-DISTRICT,Zaffergadh,18,45899,22777,23122
28,540,04697,SUB-DISTRICT,Palakurthi,21,58194,29315,28879
28,540,04698,SUB-DISTRICT,Raghunathpalle,19,53374,26563,26811
28,540,04699,SUB-DISTRICT,Jangaon,19,40052,20043,20009
28,540,04700,SUB-DISTRICT,Lingalaghanpur,13,38340,19080,19260
28,540,04701,SUB-DISTRICT,Devaruppula,13,42411,21256,21155
28,540,04702,SUB-DISTRICT,Kodakandla,16,51816,25832,25984
28,540,04703,SUB-DISTRICT,Raiparthy,18,56189,27865,28324
28,540,04704,SUB-DISTRICT,Wardhannapet,18,76873,38607,38266
28,540,04705,SUB-DISTRICT,Sangam,19,53160,26733,26427
28,540,04706,SUB-DISTRICT,Warangal,0,0,0,0
28,540,04707,SUB-DISTRICT,Geesugonda,14,39173,19462,19711
28,540,04708,SUB-DISTRICT,Narsampet,11,36276,17910,18366
28,540,04709,SUB-DISTRICT,Khanapur,10,32186,16130,16056
28,540,04710,SUB-DISTRICT,Kothagudem,58,39576,19721,19855
28,540,04711,SUB-DISTRICT,Gudur,27,55781,28225,27556
28,540,04712,SUB-DISTRICT,Chennaraopet,14,53013,26747,26266
28,540,04713,SUB-DISTRICT,Nekkonda,17,49291,24898,24393
28,540,04714,SUB-DISTRICT,Parvathagiri,13,47639,23965,23674
28,540,04715,SUB-DISTRICT,Thorrur,23,57419,28818,28601
28,540,04716,SUB-DISTRICT,Nellikudur,18,58344,29402,28942
28,540,04717,SUB-DISTRICT,Kesamudram,16,66041,32973,33068
28,540,04718,SUB-DISTRICT,Mahabubabad,19,70961,35708,35253
28,540,04719,SUB-DISTRICT,Narsimhulapet,18,58704,29690,29014
28,540,04720,SUB-DISTRICT,Maripeda,23,83876,43102,40774
28,540,04721,SUB-DISTRICT,Kuravi,20,67179,32987,34192
28,540,04722,SUB-DISTRICT,Dornakal,12,41003,20604,20399
28,541,00000,DISTRICT,Khammam,1103,2141459,1066781,1074678
28,541,04723,SUB-DISTRICT,Wazeed,44,24816,12248,12568
28,541,04724,SUB-DISTRICT,Venkatapuram,45,31765,15384,16381
28,541,04725,SUB-DISTRICT,Pinapaka,25,48376,23708,24668
28,541,04726,SUB-DISTRICT,Cherla,61,42947,21167,21780
28,541,04727,SUB-DISTRICT,Manuguru,4,40026,19911,20115
28,541,04728,SUB-DISTRICT,Aswapuram,10,43067,21757,21310
28,541,04729,SUB-DISTRICT,Dummugudem,80,46802,22781,24021
28,541,04730,SUB-DISTRICT,Bhadrachalam,65,38961,19195,19766
28,541,04731,SUB-DISTRICT,Kunavaram,50,26245,12351,13894
28,541,04732,SUB-DISTRICT,Chintur,80,40725,19899,20826
28,541,04733,SUB-DISTRICT,Vararamachandrapuram,55,25597,12171,13426
28,541,04734,SUB-DISTRICT,Velairpadu,20,22882,11007,11875
28,541,04735,SUB-DISTRICT,Kukunoor,18,28392,14104,14288
28,541,04736,SUB-DISTRICT,Burgampahad,16,42431,21421,21010
28,541,04737,SUB-DISTRICT,Palwancha,18,33673,17430,16243
28,541,04738,SUB-DISTRICT,Kothagudem,15,68690,34675,34015
28,541,04739,SUB-DISTRICT,Tekulapalle,6,47879,24029,23850
28,541,04740,SUB-DISTRICT,Yellandu,6,60338,29610,30728
28,541,04741,SUB-DISTRICT,Gundala,17,28125,13990,14135
28,541,04742,SUB-DISTRICT,Bayyaram,17,42587,21275,21312
28,541,04743,SUB-DISTRICT,Garla,10,36998,18122,18876
28,541,04744,SUB-DISTRICT,Singareni,11,54897,27596,27301
28,541,04745,SUB-DISTRICT,Kamepalle,13,41955,20882,21073
28,541,04746,SUB-DISTRICT,Julurpad,8,33395,16768,16627
28,541,04747,SUB-DISTRICT,Chandrugonda,20,49041,25038,24003
28,541,04748,SUB-DISTRICT,Mulkalapalle,11,34794,17302,17492
28,541,04749,SUB-DISTRICT,Aswaraopeta,19,59652,29963,29689
28,541,04750,SUB-DISTRICT,Dammapeta,21,58444,28975,29469
28,541,04751,SUB-DISTRICT,Sathupalle,13,45186,22618,22568
28,541,04752,SUB-DISTRICT,Penuballi,21,52841,26221,26620
28,541,04753,SUB-DISTRICT,Enkuru,11,35342,17982,17360
28,541,04754,SUB-DISTRICT,Thirumalayapalem,25,61502,30737,30765
28,541,04755,SUB-DISTRICT,Kusumanchi,18,60020,30223,29797
28,541,04756,SUB-DISTRICT,Khammam (Rural),23,81138,40727,40411
28,541,04757,SUB-DISTRICT,Khammam (Urban),12,63322,31681,31641
28,541,04758,SUB-DISTRICT,Mudigonda,21,58485,29245,29240
28,541,04759,SUB-DISTRICT,Nelakondapalle,22,61325,30238,31087
28,541,04760,SUB-DISTRICT,Chinthakani,16,48909,24180,24729
28,541,04761,SUB-DISTRICT,Konijerla,17,61321,30878,30443
28,541,04762,SUB-DISTRICT,Tallada,19,55750,27943,27807
28,541,04763,SUB-DISTRICT,Kallur,23,63828,31800,32028
28,541,04764,SUB-DISTRICT,Wyra,21,54320,26793,27527
28,541,04765,SUB-DISTRICT,Bonakal,18,43909,22065,21844
28,541,04766,SUB-DISTRICT,Madhira,23,45832,22744,23088
28,541,04767,SUB-DISTRICT,Yerrupalem,21,49851,25078,24773
28,541,04768,SUB-DISTRICT,Vemsoor,14,45078,22869,22209
28,542,00000,DISTRICT,Srikakulam,1701,2266411,1126888,1139523
28,542,04769,SUB-DISTRICT,Veeraghattam,39,65616,32339,33277
28,542,04770,SUB-DISTRICT,Seethampeta,113,55848,27146,28702
28,542,04771,SUB-DISTRICT,Bhamini,22,44157,21576,22581
28,542,04772,SUB-DISTRICT,Kothuru,34,67093,33532,33561
28,542,04773,SUB-DISTRICT,Pathapatnam,41,64639,31896,32743
28,542,04774,SUB-DISTRICT,Meliaputti,65,52737,25911,26826
28,542,04775,SUB-DISTRICT,Palasa,51,40044,19784,20260
28,542,04776,SUB-DISTRICT,Mandasa,75,82699,40252,42447
28,542,04777,SUB-DISTRICT,Kanchili,51,66657,32916,33741
28,542,04778,SUB-DISTRICT,Ichchapuram,24,52472,25242,27230
28,542,04779,SUB-DISTRICT,Kaviti,21,75974,36365,39609
28,542,04780,SUB-DISTRICT,Sompeta,34,60130,29193,30937
28,542,04781,SUB-DISTRICT,Vajrapukothuru,59,73212,36213,36999
28,542,04782,SUB-DISTRICT,Nandigam,101,56443,28032,28411
28,542,04783,SUB-DISTRICT,Hiramandalam,35,43415,21662,21753
28,542,04784,SUB-DISTRICT,Palakonda,44,54212,26802,27410
28,542,04785,SUB-DISTRICT,Vangara,32,41133,20381,20752
28,542,04786,SUB-DISTRICT,Regidi Amadalavalasa,51,70493,35385,35108
28,542,04787,SUB-DISTRICT,Lakshminarsupeta,40,29107,14638,14469
28,542,04788,SUB-DISTRICT,Saravakota,41,52243,25871,26372
28,542,04789,SUB-DISTRICT,Tekkali,48,45362,22272,23090
28,542,04790,SUB-DISTRICT,Santhabommali,39,70561,35284,35277
28,542,04791,SUB-DISTRICT,Kotabommali,43,74718,37760,36958
28,542,04792,SUB-DISTRICT,Jalumuru,53,59599,29413,30186
28,542,04793,SUB-DISTRICT,Sarubujjili,40,33254,16563,16691
28,542,04794,SUB-DISTRICT,Burja,58,42308,21426,20882
28,542,04795,SUB-DISTRICT,Santhakaviti,50,65419,32881,32538
28,542,04796,SUB-DISTRICT,Rajam,26,51842,26048,25794
28,542,04797,SUB-DISTRICT,Ganguvarisigadam,42,57543,29111,28432
28,542,04798,SUB-DISTRICT,Amadalavalasa,36,44294,22178,22116
28,542,04799,SUB-DISTRICT,Narasannapeta,43,51041,25103,25938
28,542,04800,SUB-DISTRICT,Polaki,42,65622,32880,32742
28,542,04801,SUB-DISTRICT,Gara,24,79617,39729,39888
28,542,04802,SUB-DISTRICT,Srikakulam,25,75894,37853,38041
28,542,04803,SUB-DISTRICT,Ponduru,37,61250,31086,30164
28,542,04804,SUB-DISTRICT,Laveru,41,68621,34886,33735
28,542,04805,SUB-DISTRICT,Ranastalam,54,85872,43787,42085
28,542,04806,SUB-DISTRICT,Etcherla,27,85270,43492,41778
28,543,00000,DISTRICT,Vizianagaram,1452,1853563,920428,933135
28,543,04807,SUB-DISTRICT,Komarada,92,51993,24833,27160
28,543,04808,SUB-DISTRICT,Gummalakshmipuram,118,49507,23371,26136
28,543,04809,SUB-DISTRICT,Kurupam,92,48402,23996,24406
28,543,04810,SUB-DISTRICT,Jiyyammavalasa,55,52360,26183,26177
28,543,04811,SUB-DISTRICT,Garugubilli,32,46773,23128,23645
28,543,04812,SUB-DISTRICT,Parvathipuram,46,59794,29639,30155
28,543,04813,SUB-DISTRICT,Makkuva,49,50506,25225,25281
28,543,04814,SUB-DISTRICT,Seethanagaram,43,58182,28992,29190
28,543,04815,SUB-DISTRICT,Balijipeta,31,59764,29536,30228
28,543,04816,SUB-DISTRICT,Bobbili,38,66145,32807,33338
28,543,04817,SUB-DISTRICT,Salur,83,55889,27086,28803
28,543,04818,SUB-DISTRICT,Pachipenta,51,48233,23870,24363
28,543,04819,SUB-DISTRICT,Ramabhadrapuram,31,50464,24867,25597
28,543,04820,SUB-DISTRICT,Badangi,27,49384,24881,24503
28,543,04821,SUB-DISTRICT,Therlam,47,59688,29882,29806
28,543,04822,SUB-DISTRICT,Merakamudidam,39,57237,28656,28581
28,543,04823,SUB-DISTRICT,Dattirajeru,44,54499,27124,27375
28,543,04824,SUB-DISTRICT,Mentada,37,46855,23234,23621
28,543,04825,SUB-DISTRICT,Gajapathinagaram,32,51842,25603,26239
28,543,04826,SUB-DISTRICT,Garividi,34,49396,24860,24536
28,543,04827,SUB-DISTRICT,Cheepurupalle,29,48561,24620,23941
28,543,04828,SUB-DISTRICT,Gurla,39,64695,32341,32354
28,543,04829,SUB-DISTRICT,Bondapalle,31,51146,25254,25892
28,543,04830,SUB-DISTRICT,Gantyada,44,65579,32696,32883
28,543,04831,SUB-DISTRICT,Srungavarapukota,39,75917,37123,38794
28,543,04832,SUB-DISTRICT,Vepada,37,50580,24930,25650
28,543,04833,SUB-DISTRICT,Lakkavarapukota,32,53039,26531,26508
28,543,04834,SUB-DISTRICT,Kothavalasa,26,49347,24300,25047
28,543,04835,SUB-DISTRICT,Jami,27,58066,28987,29079
28,543,04836,SUB-DISTRICT,Vizianagaram,14,43641,22105,21536
28,543,04837,SUB-DISTRICT,Nellimarla,31,50772,25626,25146
28,543,04838,SUB-DISTRICT,Pusapatirega,36,71955,36508,35447
28,543,04839,SUB-DISTRICT,Denkada,27,48461,24231,24230
28,543,04840,SUB-DISTRICT,Bhogapuram,19,54891,27403,27488
28,544,00000,DISTRICT,Visakhapatnam,3072,2254667,1113234,1141433
28,544,04841,SUB-DISTRICT,Munchingi Puttu,303,47418,22937,24481
28,544,04842,SUB-DISTRICT,Peda Bayalu,268,51890,25542,26348
28,544,04843,SUB-DISTRICT,Dumbriguda,87,49029,23801,25228
28,544,04844,SUB-DISTRICT,Araku Valley,163,49960,23571,26389
28,544,04845,SUB-DISTRICT,Ananthagiri,278,49019,24427,24592
28,544,04846,SUB-DISTRICT,Hukumpeta,168,51697,25137,26560
28,544,04847,SUB-DISTRICT,Paderu,199,50196,24125,26071
28,544,04848,SUB-DISTRICT,G.Madugula,292,53884,26966,26918
28,544,04849,SUB-DISTRICT,Chintapalle,244,63752,31021,32731
28,544,04850,SUB-DISTRICT,Gudem Kotha Veedhi,170,58542,27869,30673
28,544,04851,SUB-DISTRICT,Koyyuru,136,50639,25047,25592
28,544,04852,SUB-DISTRICT,Nathavaram,35,64607,32202,32405
28,544,04853,SUB-DISTRICT,Golugonda,34,52852,26353,26499
28,544,04854,SUB-DISTRICT,Narsipatnam,11,45074,22115,22959
28,544,04855,SUB-DISTRICT,Rolugunta,28,48388,23474,24914
28,544,04856,SUB-DISTRICT,Ravikamatham,33,70761,34108,36653
28,544,04857,SUB-DISTRICT,Madugula,49,72006,35220,36786
28,544,04858,SUB-DISTRICT,Cheedikada,30,46643,22907,23736
28,544,04859,SUB-DISTRICT,Devarapalle,40,58312,29220,29092
28,544,04860,SUB-DISTRICT,K.Kotapadu,32,60498,30033,30465
28,544,04861,SUB-DISTRICT,Sabbavaram,27,62713,31711,31002
28,544,04862,SUB-DISTRICT,Pendurthi,15,32380,16070,16310
28,544,04863,SUB-DISTRICT,Anandapuram,32,60789,30739,30050
28,544,04864,SUB-DISTRICT,Padmanabham,24,52079,25946,26133
28,544,04865,SUB-DISTRICT,Bheemunipatnam,18,56754,28687,28067
28,544,04866,SUB-DISTRICT,Visakhapatnam (Rural),0,0,0,0
28,544,04867,SUB-DISTRICT,Visakhapatnam (Urban),0,0,0,0
28,544,04868,SUB-DISTRICT,Pedagantyada,0,0,0,0
28,544,04869,SUB-DISTRICT,Gajuwaka,0,0,0,0
28,544,04870,SUB-DISTRICT,Paravada,14,52605,26422,26183
28,544,04871,SUB-DISTRICT,Anakapalle,31,95417,47200,48217
28,544,04872,SUB-DISTRICT,Chodavaram,30,68242,33791,34451
28,544,04873,SUB-DISTRICT,Butchayyapeta,38,66214,32896,33318
28,544,04874,SUB-DISTRICT,Kotauratla,20,54510,26911,27599
28,544,04875,SUB-DISTRICT,Makavarapalem,25,57568,28328,29240
28,544,04876,SUB-DISTRICT,Kasimkota,26,67262,32768,34494
28,544,04877,SUB-DISTRICT,Munagapaka,26,55520,27822,27698
28,544,04878,SUB-DISTRICT,Atchutapuram,33,66577,33503,33074
28,544,04879,SUB-DISTRICT,Yelamanchili,13,43288,20795,22493
28,544,04880,SUB-DISTRICT,Nakkapalle,30,73476,36801,36675
28,544,04881,SUB-DISTRICT,Payakaraopeta,18,66092,33573,32519
28,544,04882,SUB-DISTRICT,S.Rayavaram,22,74101,36384,37717
28,544,04883,SUB-DISTRICT,Rambilli,30,53913,26812,27101
28,545,00000,DISTRICT,East Godavari,1312,3840324,1922293,1918031
28,545,04884,SUB-DISTRICT,Maredumilli,69,19507,10166,9341
28,545,04885,SUB-DISTRICT,Devipatnam,44,28178,13669,14509
28,545,04886,SUB-DISTRICT,Y. Ramavaram,125,28614,13757,14857
28,545,04887,SUB-DISTRICT,Addateegala,90,37241,18686,18555
28,545,04888,SUB-DISTRICT,Rajavommangi,61,39582,19102,20480
28,545,04889,SUB-DISTRICT,Kotananduru,14,48512,24096,24416
28,545,04890,SUB-DISTRICT,Tuni,20,84654,41812,42842
28,545,04891,SUB-DISTRICT,Rowthulapudi,38,55236,28050,27186
28,545,04892,SUB-DISTRICT,Sankhavaram,29,51944,26038,25906
28,545,04893,SUB-DISTRICT,Yeleswaram,12,77965,38471,39494
28,545,04894,SUB-DISTRICT,Gangavaram,54,25912,12393,13519
28,545,04895,SUB-DISTRICT,Rampachodavaram,73,29399,13943,15456
28,545,04896,SUB-DISTRICT,Seethanagaram,17,71665,35728,35937
28,545,04897,SUB-DISTRICT,Gokavaram,14,69596,34352,35244
28,545,04898,SUB-DISTRICT,Jaggampeta,19,79640,39422,40218
28,545,04899,SUB-DISTRICT,Kirlampudi,17,74379,37255,37124
28,545,04900,SUB-DISTRICT,Prathipadu,36,79076,39501,39575
28,545,04901,SUB-DISTRICT,Thondangi,15,87592,44412,43180
28,545,04902,SUB-DISTRICT,Gollaprolu,10,78926,39773,39153
28,545,04903,SUB-DISTRICT,Peddapuram,20,73922,37379,36543
28,545,04904,SUB-DISTRICT,Gandepalle,13,54278,27075,27203
28,545,04905,SUB-DISTRICT,Korukonda,18,79553,39620,39933
28,545,04906,SUB-DISTRICT,Rajahmundry (Urban),0,0,0,0
28,545,04907,SUB-DISTRICT,Rajahmundry Rural,3,31931,16005,15926
28,545,04908,SUB-DISTRICT,Rajanagaram,17,106085,53345,52740
28,545,04909,SUB-DISTRICT,Rangampeta,15,57106,28913,28193
28,545,04910,SUB-DISTRICT,Samalkota,17,81115,40548,40567
28,545,04911,SUB-DISTRICT,Pithapuram,22,74423,37743,36680
28,545,04912,SUB-DISTRICT,Kothapalle,16,82788,41466,41322
28,545,04913,SUB-DISTRICT,Kakinada (Rural),8,43639,22130,21509
28,545,04914,SUB-DISTRICT,Kakinada (Urban),0,0,0,0
28,545,04915,SUB-DISTRICT,Pedapudi,17,71459,35883,35576
28,545,04916,SUB-DISTRICT,Biccavolu,13,70277,34695,35582
28,545,04917,SUB-DISTRICT,Anaparthy,9,70859,35395,35464
28,545,04918,SUB-DISTRICT,Kadiam,7,90499,45066,45433
28,545,04919,SUB-DISTRICT,Atreyapuram,15,65580,33096,32484
28,545,04920,SUB-DISTRICT,Mandapeta,13,76616,38144,38472
28,545,04921,SUB-DISTRICT,Rayavaram,10,66456,32982,33474
28,545,04922,SUB-DISTRICT,Karapa,19,76398,38460,37938
28,545,04923,SUB-DISTRICT,Kajuluru,20,70903,35825,35078
28,545,04924,SUB-DISTRICT,Ramachandrapuram,20,70870,35866,35004
28,545,04925,SUB-DISTRICT,Alamuru,15,74025,36955,37070
28,545,04926,SUB-DISTRICT,Ravulapalem,10,83360,41862,41498
28,545,04927,SUB-DISTRICT,Kothapeta,10,77859,39053,38806
28,545,04928,SUB-DISTRICT,Kapileswarapuram,15,66809,33583,33226
28,545,04929,SUB-DISTRICT,Pamarru,24,63013,31835,31178
28,545,04930,SUB-DISTRICT,Thallarevu,13,82799,41438,41361
28,545,04931,SUB-DISTRICT,I. Polavaram,11,67434,33977,33457
28,545,04932,SUB-DISTRICT,Mummidivaram,11,68586,34389,34197
28,545,04933,SUB-DISTRICT,Ainavilli,16,65161,32858,32303
28,545,04934,SUB-DISTRICT,P.Gannavaram,18,75306,38097,37209
28,545,04935,SUB-DISTRICT,Ambajipeta,13,63134,31662,31472
28,545,04936,SUB-DISTRICT,Mamidikuduru,17,70639,35506,35133
28,545,04937,SUB-DISTRICT,Razole,13,71433,35468,35965
28,545,04938,SUB-DISTRICT,Malikipuram,11,75847,37989,37858
28,545,04939,SUB-DISTRICT,Sakhinetipalle,8,72560,36403,36157
28,545,04940,SUB-DISTRICT,Allavaram,14,68242,34034,34208
28,545,04941,SUB-DISTRICT,Amalapuram,16,76992,38873,38119
28,545,04942,SUB-DISTRICT,Uppalaguptam,14,59931,30285,29646
28,545,04943,SUB-DISTRICT,Katrenikona,14,74819,37764,37055
28,546,00000,DISTRICT,West Godavari,842,3128189,1567013,1561176
28,546,04944,SUB-DISTRICT,Chintalapudi,35,91372,45350,46022
28,546,04945,SUB-DISTRICT,Lingapalem,24,58360,29546,28814
28,546,04946,SUB-DISTRICT,T.Narasapuram,22,56179,28523,27656
28,546,04947,SUB-DISTRICT,Jeelugu Milli,26,30077,15163,14914
28,546,04948,SUB-DISTRICT,Buttayagudem,50,53031,25533,27498
28,546,04949,SUB-DISTRICT,Polavaram,21,45392,22345,23047
28,546,04950,SUB-DISTRICT,Tallapudi,16,52785,26295,26490
28,546,04951,SUB-DISTRICT,Gopalapuram,18,62597,31040,31557
28,546,04952,SUB-DISTRICT,Koyyalagudem,18,75694,37755,37939
28,546,04953,SUB-DISTRICT,Jangareddigudem,20,109814,54682,55132
28,546,04954,SUB-DISTRICT,Kamavarapukota,15,57636,29248,28388
28,546,04955,SUB-DISTRICT,Dwarakatirumala,30,63446,32305,31141
28,546,04956,SUB-DISTRICT,Nallajerla,12,80388,40391,39997
28,546,04957,SUB-DISTRICT,Devarapalle,13,77971,38967,39004
28,546,04958,SUB-DISTRICT,Kovvur,15,68778,34148,34630
28,546,04959,SUB-DISTRICT,Chagallu,11,64774,32440,32334
28,546,04960,SUB-DISTRICT,Nidadavole,22,70436,35428,35008
28,546,04961,SUB-DISTRICT,Tadepalligudem,17,88130,44490,43640
28,546,04962,SUB-DISTRICT,Unguturu,17,80722,40417,40305
28,546,04963,SUB-DISTRICT,Bhimadole,11,65216,32392,32824
28,546,04964,SUB-DISTRICT,Pedavegi,28,88834,45172,43662
28,546,04965,SUB-DISTRICT,Pedapadu,23,69141,33878,35263
28,546,04966,SUB-DISTRICT,Eluru,17,68571,33998,34573
28,546,04967,SUB-DISTRICT,Denduluru,26,66695,33425,33270
28,546,04968,SUB-DISTRICT,Nidamarru,21,47623,24011,23612
28,546,04969,SUB-DISTRICT,Pentapadu,21,70458,35349,35109
28,546,04970,SUB-DISTRICT,Undrajavaram,15,76489,38715,37774
28,546,04971,SUB-DISTRICT,Peravali,14,70194,35178,35016
28,546,04972,SUB-DISTRICT,Tanuku,8,70567,34814,35753
28,546,04973,SUB-DISTRICT,Attili,14,68881,34590,34291
28,546,04974,SUB-DISTRICT,Ganapavaram,25,64963,32519,32444
28,546,04975,SUB-DISTRICT,Akividu,15,73889,36778,37111
28,546,04976,SUB-DISTRICT,Undi,20,66049,32750,33299
28,546,04977,SUB-DISTRICT,Palacoderu,14,66119,32927,33192
28,546,04978,SUB-DISTRICT,Penumantra,16,60153,30043,30110
28,546,04979,SUB-DISTRICT,Iragavaram,21,65831,33202,32629
28,546,04980,SUB-DISTRICT,Penugonda,14,69317,34837,34480
28,546,04981,SUB-DISTRICT,Achanta,10,60711,30614,30097
28,546,04982,SUB-DISTRICT,Poduru,14,65706,33128,32578
28,546,04983,SUB-DISTRICT,Veeravasaram,14,64912,32803,32109
28,546,04984,SUB-DISTRICT,Bhimavaram,14,79536,39842,39694
28,546,04985,SUB-DISTRICT,Kalla,13,68118,34182,33936
28,546,04986,SUB-DISTRICT,Mogalthur,6,72255,36258,35997
28,546,04987,SUB-DISTRICT,Narasapuram,15,79971,40609,39362
28,546,04988,SUB-DISTRICT,Palacole,16,48518,24432,24086
28,546,04989,SUB-DISTRICT,Yelamanchili,15,71890,36501,35389
28,547,00000,DISTRICT,Krishna,934,2673738,1343534,1330204
28,547,04990,SUB-DISTRICT,Vatsavai,23,61749,30670,31079
28,547,04991,SUB-DISTRICT,Jaggayyapeta,24,72745,36229,36516
28,547,04992,SUB-DISTRICT,Penuganchiprolu,13,51811,25782,26029
28,547,04993,SUB-DISTRICT,Nandigama,25,92291,46218,46073
28,547,04994,SUB-DISTRICT,Veerullapadu,24,49089,24420,24669
28,547,04995,SUB-DISTRICT,Mylavaram,17,66947,33684,33263
28,547,04996,SUB-DISTRICT,Gampalagudem,21,71544,36215,35329
28,547,04997,SUB-DISTRICT,Tiruvuru,18,58164,29439,28725
28,547,04998,SUB-DISTRICT,A.Konduru,13,48463,24675,23788
28,547,04999,SUB-DISTRICT,Reddigudem,11,46226,23522,22704
28,547,05000,SUB-DISTRICT,Vissannapet,10,59798,29866,29932
28,547,05001,SUB-DISTRICT,Chatrai,16,53493,27080,26413
28,547,05002,SUB-DISTRICT,Musunuru,16,57197,28941,28256
28,547,05003,SUB-DISTRICT,Nuzvid,25,70963,35884,35079
28,547,05004,SUB-DISTRICT,Bapulapadu,28,84922,42406,42516
28,547,05005,SUB-DISTRICT,Agiripalle,21,62098,31780,30318
28,547,05006,SUB-DISTRICT,G.Konduru,25,57693,29073,28620
28,547,05007,SUB-DISTRICT,Kanchikacherla,15,71075,35430,35645
28,547,05008,SUB-DISTRICT,Chandarlapadu,20,59943,30277,29666
28,547,05009,SUB-DISTRICT,Ibrahimpatnam,13,29567,14860,14707
28,547,05010,SUB-DISTRICT,Vijayawada (Urban),0,0,0,0
28,547,05011,SUB-DISTRICT,Vijayawada (Rural),7,18929,9624,9305
28,547,05012,SUB-DISTRICT,Gannavaram,23,87027,43172,43855
28,547,05013,SUB-DISTRICT,Unguturu,27,54323,26660,27663
28,547,05014,SUB-DISTRICT,Nandivada,22,36924,18491,18433
28,547,05015,SUB-DISTRICT,Mandavalli,31,48627,24342,24285
28,547,05016,SUB-DISTRICT,Kaikalur,23,77654,38890,38764
28,547,05017,SUB-DISTRICT,Kalidindi,14,70729,35364,35365
28,547,05018,SUB-DISTRICT,Kruthivennu,15,48892,24405,24487
28,547,05019,SUB-DISTRICT,Bantumilli,18,46370,23116,23254
28,547,05020,SUB-DISTRICT,Mudinepalle,32,64377,32300,32077
28,547,05021,SUB-DISTRICT,Gudivada,28,43286,21690,21596
28,547,05022,SUB-DISTRICT,Pedaparupudi,18,31348,15474,15874
28,547,05023,SUB-DISTRICT,Kankipadu,18,54946,28907,26039
28,547,05024,SUB-DISTRICT,Penamaluru,4,18905,9249,9656
28,547,05025,SUB-DISTRICT,Thotlavalluru,16,38641,19118,19523
28,547,05026,SUB-DISTRICT,Pamidimukkala,27,53913,26835,27078
28,547,05027,SUB-DISTRICT,Vuyyuru,12,76703,38237,38466
28,547,05028,SUB-DISTRICT,Pamarru,25,54634,26847,27787
28,547,05029,SUB-DISTRICT,Gudlavalleru,22,51753,25711,26042
28,547,05030,SUB-DISTRICT,Pedana,29,34936,17748,17188
28,547,05031,SUB-DISTRICT,Guduru,25,49228,24823,24405
28,547,05032,SUB-DISTRICT,Movva,17,52974,26666,26308
28,547,05033,SUB-DISTRICT,Ghantasala,20,40098,20182,19916
28,547,05034,SUB-DISTRICT,Machilipatnam,28,69070,35226,33844
28,547,05035,SUB-DISTRICT,Challapalle,11,53540,26593,26947
28,547,05036,SUB-DISTRICT,Mopidevi,17,35967,18447,17520
28,547,05037,SUB-DISTRICT,Avanigadda,7,40986,20966,20020
28,547,05038,SUB-DISTRICT,Nagayalanka,11,47899,25076,22823
28,547,05039,SUB-DISTRICT,Koduru,9,45281,22924,22357
28,548,00000,DISTRICT,Guntur,691,3235075,1621491,1613584
28,548,05040,SUB-DISTRICT,Macherla,11,55758,28686,27072
28,548,05041,SUB-DISTRICT,Veldurthi,9,49054,24608,24446
28,548,05042,SUB-DISTRICT,Durgi,10,49059,24571,24488
28,548,05043,SUB-DISTRICT,Rentachintala,9,49827,25058,24769
28,548,05044,SUB-DISTRICT,Gurazala,10,66070,32945,33125
28,548,05045,SUB-DISTRICT,Dachepalle,12,75233,37623,37610
28,548,05046,SUB-DISTRICT,Karempudi,11,52367,26525,25842
28,548,05047,SUB-DISTRICT,Piduguralla,9,59216,29820,29396
28,548,05048,SUB-DISTRICT,Machavaram,9,52469,26391,26078
28,548,05049,SUB-DISTRICT,Bellamkonda,13,38455,19466,18989
28,548,05050,SUB-DISTRICT,Atchampet,18,58447,29749,28698
28,548,05051,SUB-DISTRICT,Krosuru,15,56308,28211,28097
28,548,05052,SUB-DISTRICT,Amaravathi,16,66277,32709,33568
28,548,05053,SUB-DISTRICT,Thullur,20,54081,26791,27290
28,548,05054,SUB-DISTRICT,Tadepalle,6,29004,14564,14440
28,548,05055,SUB-DISTRICT,Mangalagiri,9,53106,27062,26044
28,548,05056,SUB-DISTRICT,Tadikonda,12,67962,33655,34307
28,548,05057,SUB-DISTRICT,Pedakurapadu,14,50030,25031,24999
28,548,05058,SUB-DISTRICT,Sattenapalle,17,73887,36414,37473
28,548,05059,SUB-DISTRICT,Rajupalem,8,45213,22591,22622
28,548,05060,SUB-DISTRICT,Nekarikallu,10,63349,31902,31447
28,548,05061,SUB-DISTRICT,Bollapalle,14,58086,29245,28841
28,548,05062,SUB-DISTRICT,Vinukonda,21,49948,25012,24936
28,548,05063,SUB-DISTRICT,Nuzendla,20,52853,26201,26652
28,548,05064,SUB-DISTRICT,Savalyapuram H/O Kanamarlapudi,7,37994,19163,18831
28,548,05065,SUB-DISTRICT,Ipur,13,46714,23472,23242
28,548,05066,SUB-DISTRICT,Rompicherla,14,62060,31160,30900
28,548,05067,SUB-DISTRICT,Narasaraopet,15,94459,47502,46957
28,548,05068,SUB-DISTRICT,Muppalla,9,42509,21285,21224
28,548,05069,SUB-DISTRICT,Nadendla,10,68978,34983,33995
28,548,05070,SUB-DISTRICT,"Chilakaluripet
 H/O.Purushotha Patnam",13,52231,25969,26262
28,548,05071,SUB-DISTRICT,Edlapadu,12,56321,28211,28110
28,548,05072,SUB-DISTRICT,Phirangipuram,14,63449,31654,31795
28,548,05073,SUB-DISTRICT,Medikonduru,12,60144,30682,29462
28,548,05074,SUB-DISTRICT,Guntur,11,109216,58147,51069
28,548,05075,SUB-DISTRICT,Pedakakani,10,73689,36396,37293
28,548,05076,SUB-DISTRICT,Duggirala,14,62655,31269,31386
28,548,05077,SUB-DISTRICT,Kollipara,14,56662,27953,28709
28,548,05078,SUB-DISTRICT,Tenali,11,75094,37189,37905
28,548,05079,SUB-DISTRICT,Chebrolu,10,72141,36015,36126
28,548,05080,SUB-DISTRICT,Vatticherukuru,13,45773,22700,23073
28,548,05081,SUB-DISTRICT,Prathipadu,10,49390,25085,24305
28,548,05082,SUB-DISTRICT,Pedanandipadu,12,41980,20643,21337
28,548,05083,SUB-DISTRICT,Kakumanu,11,40681,20082,20599
28,548,05084,SUB-DISTRICT,Ponnur,18,63504,31467,32037
28,548,05085,SUB-DISTRICT,Tsundur,12,45778,22599,23179
28,548,05086,SUB-DISTRICT,Amruthalur,13,44713,22123,22590
28,548,05087,SUB-DISTRICT,Vemuru,12,43586,21752,21834
28,548,05088,SUB-DISTRICT,Kollur,11,55323,27709,27614
28,548,05089,SUB-DISTRICT,Bhattiprolu,12,50252,25134,25118
28,548,05090,SUB-DISTRICT,Cherukupalle H/O Arumbaka,10,60385,29852,30533
28,548,05091,SUB-DISTRICT,Pittalavanipalem,6,38609,19175,19434
28,548,05092,SUB-DISTRICT,Karlapalem,5,50320,25232,25088
28,548,05093,SUB-DISTRICT,Bapatla,18,73048,36462,36586
28,548,05094,SUB-DISTRICT,Nizampatnam,8,59973,30533,29440
28,548,05095,SUB-DISTRICT,Nagaram,12,50262,24989,25273
28,548,05096,SUB-DISTRICT,Repalle,16,61123,30074,31049
28,549,00000,DISTRICT,Prakasam,985,2732866,1382641,1350225
28,549,05097,SUB-DISTRICT,Yerragondapalem,22,64063,33160,30903
28,549,05098,SUB-DISTRICT,Pullalacheruvu,16,53279,27258,26021
28,549,05099,SUB-DISTRICT,Tripuranthakam,15,62627,31740,30887
28,549,05100,SUB-DISTRICT,Dornala,19,44187,22504,21683
28,549,05101,SUB-DISTRICT,Peda  Araveedu,16,42262,21630,20632
28,549,05102,SUB-DISTRICT,Donakonda,27,48148,24706,23442
28,549,05103,SUB-DISTRICT,Kurichedu,17,40801,20837,19964
28,549,05104,SUB-DISTRICT,Santhamaguluru,10,59528,30355,29173
28,549,05105,SUB-DISTRICT,Ballikurava,14,53269,26942,26327
28,549,05106,SUB-DISTRICT,Martur,13,73862,37083,36779
28,549,05107,SUB-DISTRICT,Yeddana Pudi,8,28373,13417,14956
28,549,05108,SUB-DISTRICT,Parchur,14,54668,26622,28046
28,549,05109,SUB-DISTRICT,Karamchedu,7,38916,19422,19494
28,549,05110,SUB-DISTRICT,Inkollu,9,49546,24905,24641
28,549,05111,SUB-DISTRICT,Janakavarampanguluru,15,45186,22486,22700
28,549,05112,SUB-DISTRICT,Addanki,18,89769,44874,44895
28,549,05113,SUB-DISTRICT,Mundlamuru,28,56783,29057,27726
28,549,05114,SUB-DISTRICT,Darsi,32,86702,44508,42194
28,549,05115,SUB-DISTRICT,Markapur,21,51892,26421,25471
28,549,05116,SUB-DISTRICT,Ardhaveedu,12,36169,18651,17518
28,549,05117,SUB-DISTRICT,Cumbum,13,33529,16375,17154
28,549,05118,SUB-DISTRICT,Tarlupadu,25,34640,17789,16851
28,549,05119,SUB-DISTRICT,Konakanamitla,33,49259,25417,23842
28,549,05120,SUB-DISTRICT,Podili,29,35872,18383,17489
28,549,05121,SUB-DISTRICT,Thallur,13,48400,24848,23552
28,549,05122,SUB-DISTRICT,Korisapadu,10,48273,23958,24315
28,549,05123,SUB-DISTRICT,Chirala,2,52590,26550,26040
28,549,05124,SUB-DISTRICT,Vetapalem,4,32984,16518,16466
28,549,05125,SUB-DISTRICT,Chinaganjam,7,42468,21249,21219
28,549,05126,SUB-DISTRICT,Naguluppala Padu,18,67733,33867,33866
28,549,05127,SUB-DISTRICT,Maddipadu,18,52353,26155,26198
28,549,05128,SUB-DISTRICT,Chimakurthi,24,79343,40115,39228
28,549,05129,SUB-DISTRICT,Marripudi,24,38848,19628,19220
28,549,05130,SUB-DISTRICT,Hanumanthuni Padu,25,30964,15865,15099
28,549,05131,SUB-DISTRICT,Bestawaripeta,19,51062,26119,24943
28,549,05132,SUB-DISTRICT,Racherla,11,35080,17459,17621
28,549,05133,SUB-DISTRICT,Giddalur,17,50983,25958,25025
28,549,05134,SUB-DISTRICT,Komarolu,20,40517,20553,19964
28,549,05135,SUB-DISTRICT,Veligandla,21,35951,18686,17265
28,549,05136,SUB-DISTRICT,Kanigiri,33,55046,28469,26577
28,549,05137,SUB-DISTRICT,Kondapi,17,43004,21457,21547
28,549,05138,SUB-DISTRICT,Santhanuthala Padu,16,62588,32335,30253
28,549,05139,SUB-DISTRICT,Ongole,16,48376,24148,24228
28,549,05140,SUB-DISTRICT,Kotha Patnam,7,50006,24987,25019
28,549,05141,SUB-DISTRICT,Tangutur,14,62618,31172,31446
28,549,05142,SUB-DISTRICT,Zarugumilli,20,42866,21617,21249
28,549,05143,SUB-DISTRICT,Ponnaluru,21,43016,21844,21172
28,549,05144,SUB-DISTRICT,Pedacherlo Palle,19,36985,18842,18143
28,549,05145,SUB-DISTRICT,Chandra Sekhara Puram,36,44953,23142,21811
28,549,05146,SUB-DISTRICT,Pamur,28,43017,21866,21151
28,549,05147,SUB-DISTRICT,Voletivaripalem,20,39855,20175,19680
28,549,05148,SUB-DISTRICT,Kandukur,18,41523,21017,20506
28,549,05149,SUB-DISTRICT,Singarayakonda,7,39239,19600,19639
28,549,05150,SUB-DISTRICT,Lingasamudram,18,38094,19114,18980
28,549,05151,SUB-DISTRICT,Gudluru,18,46883,23814,23069
28,549,05152,SUB-DISTRICT,Ulavapadu,11,53918,26972,26946
28,550,00000,DISTRICT,Sri Potti Sriramulu Nellore,1093,2105927,1060810,1045117
28,550,05153,SUB-DISTRICT,Seetharamapuram,21,22785,11584,11201
28,550,05154,SUB-DISTRICT,Udayagiri,16,36378,18515,17863
28,550,05155,SUB-DISTRICT,Varikuntapadu,27,32828,16744,16084
28,550,05156,SUB-DISTRICT,Kondapuram,23,39007,19835,19172
28,550,05157,SUB-DISTRICT,Jaladanki,12,45853,23100,22753
28,550,05158,SUB-DISTRICT,Kavali,15,60234,30297,29937
28,550,05159,SUB-DISTRICT,Bogole,12,49088,24570,24518
28,550,05160,SUB-DISTRICT,Kaligiri,20,43954,22362,21592
28,550,05161,SUB-DISTRICT,Vinjamur,15,41392,21324,20068
28,550,05162,SUB-DISTRICT,Duttalur,15,27291,13835,13456
28,550,05163,SUB-DISTRICT,Marripadu,21,44698,22946,21752
28,550,05164,SUB-DISTRICT,Atmakur,21,61217,30790,30427
28,550,05165,SUB-DISTRICT,Anumasamudrampeta,23,33620,17169,16451
28,550,05166,SUB-DISTRICT,Dagadarthi,22,37438,18881,18557
28,550,05167,SUB-DISTRICT,Allur,13,52602,26272,26330
28,550,05168,SUB-DISTRICT,Vidavalur,10,47489,23981,23508
28,550,05169,SUB-DISTRICT,Kodavalur,15,48820,23988,24832
28,550,05170,SUB-DISTRICT,Buchireddipalem,14,78470,38969,39501
28,550,05171,SUB-DISTRICT,Sangam,16,44735,22003,22732
28,550,05172,SUB-DISTRICT,Chejerla,18,34630,17784,16846
28,550,05173,SUB-DISTRICT,Ananthasagaram,18,42950,21898,21052
28,550,05174,SUB-DISTRICT,Kaluvoya,20,43242,22035,21207
28,550,05175,SUB-DISTRICT,Rapur,34,45747,22712,23035
28,550,05176,SUB-DISTRICT,Podalakur,36,68148,34215,33933
28,550,05177,SUB-DISTRICT,Nellore,26,73243,36933,36310
28,550,05178,SUB-DISTRICT,Kovur,10,76598,37842,38756
28,550,05179,SUB-DISTRICT,Indukurpet,16,58543,29075,29468
28,550,05180,SUB-DISTRICT,Thotapalligudur,20,50490,24911,25579
28,550,05181,SUB-DISTRICT,Muthukur,15,58003,29864,28139
28,550,05182,SUB-DISTRICT,Venkatachalam,20,61275,30784,30491
28,550,05183,SUB-DISTRICT,Manubolu,18,39074,19422,19652
28,550,05184,SUB-DISTRICT,Gudur,21,42980,21602,21378
28,550,05185,SUB-DISTRICT,Sydapuram,33,43704,22085,21619
28,550,05186,SUB-DISTRICT,Dakkili,43,40452,20174,20278
28,550,05187,SUB-DISTRICT,Venkatagiri,54,26900,13644,13256
28,550,05188,SUB-DISTRICT,Balayapalle,46,33864,17141,16723
28,550,05189,SUB-DISTRICT,Ojili,43,34528,17657,16871
28,550,05190,SUB-DISTRICT,Chillakur,28,52451,27030,25421
28,550,05191,SUB-DISTRICT,Kota,19,55226,28337,26889
28,550,05192,SUB-DISTRICT,Vakadu,32,37695,19082,18613
28,550,05193,SUB-DISTRICT,Chittamur,34,40241,20503,19738
28,550,05194,SUB-DISTRICT,Naidupet,30,38820,19012,19808
28,550,05195,SUB-DISTRICT,Pellakur,28,34455,17200,17255
28,550,05196,SUB-DISTRICT,Doravarisatram,41,35971,18120,17851
28,550,05197,SUB-DISTRICT,Sullurpeta,38,48453,24340,24113
28,550,05198,SUB-DISTRICT,Tada,21,40345,20243,20102
28,551,00000,DISTRICT,Y.S.R.,830,1903337,959693,943644
28,551,05199,SUB-DISTRICT,Kondapuram,33,42093,21046,21047
28,551,05200,SUB-DISTRICT,Mylavaram,24,26876,13262,13614
28,551,05201,SUB-DISTRICT,Peddamudium,25,32541,16270,16271
28,551,05202,SUB-DISTRICT,Rajupalem,17,32829,16120,16709
28,551,05203,SUB-DISTRICT,Duvvur,19,51872,26201,25671
28,551,05204,SUB-DISTRICT,S.Mydukur,15,81019,40837,40182
28,551,05205,SUB-DISTRICT,Brahmamgarimattam,18,37278,19413,17865
28,551,05206,SUB-DISTRICT,Sri Avadhutha Kasinayana,16,30532,15633,14899
28,551,05207,SUB-DISTRICT,Kalasapadu,23,31296,15926,15370
28,551,05208,SUB-DISTRICT,Porumamilla,26,57937,29448,28489
28,551,05209,SUB-DISTRICT,B.Kodur,15,20471,10611,9860
28,551,05210,SUB-DISTRICT,Badvel,18,21317,10857,10460
28,551,05211,SUB-DISTRICT,Gopavaram,7,17661,9112,8549
28,551,05212,SUB-DISTRICT,Khajipet,15,50320,25232,25088
28,551,05213,SUB-DISTRICT,Chapad,17,41379,20765,20614
28,551,05214,SUB-DISTRICT,Proddatur,12,41093,20505,20588
28,551,05215,SUB-DISTRICT,Jammalamadugu,16,25445,12676,12769
28,551,05216,SUB-DISTRICT,Muddanur,21,24591,12393,12198
28,551,05217,SUB-DISTRICT,Simhadripuram,20,32819,16332,16487
28,551,05218,SUB-DISTRICT,Lingala,18,29945,15261,14684
28,551,05219,SUB-DISTRICT,Pulivendla,7,13178,6757,6421
28,551,05220,SUB-DISTRICT,Vemula,12,29160,14855,14305
28,551,05221,SUB-DISTRICT,Thondur,16,23964,11774,12190
28,551,05222,SUB-DISTRICT,Veerapunayunipalle,18,32910,16534,16376
28,551,05223,SUB-DISTRICT,Yerraguntla,15,44498,22390,22108
28,551,05224,SUB-DISTRICT,Kamalapuram,23,52168,25969,26199
28,551,05225,SUB-DISTRICT,Vallur,16,28873,14614,14259
28,551,05226,SUB-DISTRICT,Chennur,13,34414,17216,17198
28,551,05227,SUB-DISTRICT,Atlur,16,24339,12298,12041
28,551,05228,SUB-DISTRICT,Vontimitta,12,33100,16900,16200
28,551,05229,SUB-DISTRICT,Sidhout,18,37452,18937,18515
28,551,05230,SUB-DISTRICT,Kadapa,0,0,0,0
28,551,05231,SUB-DISTRICT,Chinthakommadinne,16,31384,15877,15507
28,551,05232,SUB-DISTRICT,Pendlimarri,22,44008,22417,21591
28,551,05233,SUB-DISTRICT,Vempalle,11,61344,31392,29952
28,551,05234,SUB-DISTRICT,Chakrayapet,16,31258,16062,15196
28,551,05235,SUB-DISTRICT,Galiveedu,14,50833,25557,25276
28,551,05236,SUB-DISTRICT,Chinnamandem,9,34515,17324,17191
28,551,05237,SUB-DISTRICT,Sambepalle,11,37006,18330,18676
28,551,05238,SUB-DISTRICT,T Sundupalle,12,57140,28880,28260
28,551,05239,SUB-DISTRICT,Rayachoti,14,26266,13173,13093
28,551,05240,SUB-DISTRICT,Lakkireddipalle,11,35246,17758,17488
28,551,05241,SUB-DISTRICT,Ramapuram,12,35220,18031,17189
28,551,05242,SUB-DISTRICT,Veeraballe,8,35530,18037,17493
28,551,05243,SUB-DISTRICT,Nandalur,18,27584,13515,14069
28,551,05244,SUB-DISTRICT,Penagalur,24,42360,21406,20954
28,551,05245,SUB-DISTRICT,Chitvel,18,42104,21070,21034
28,551,05246,SUB-DISTRICT,Rajampet,22,49821,24944,24877
28,551,05247,SUB-DISTRICT,Pullampeta,24,39434,19592,19842
28,551,05248,SUB-DISTRICT,Obulavaripalle,13,48100,24516,23584
28,551,05249,SUB-DISTRICT,Kodur,14,90814,45668,45146
28,552,00000,DISTRICT,Kurnool,870,2904177,1464569,1439608
28,552,05250,SUB-DISTRICT,Mantralayam,20,61294,30466,30828
28,552,05251,SUB-DISTRICT,Kosigi,24,69275,34768,34507
28,552,05252,SUB-DISTRICT,Kowthalam,33,78149,38489,39660
28,552,05253,SUB-DISTRICT,Pedda Kadubur,18,56966,28350,28616
28,552,05254,SUB-DISTRICT,Yemmiganur,18,74195,36934,37261
28,552,05255,SUB-DISTRICT,Nandavaram,19,61215,30940,30275
28,552,05256,SUB-DISTRICT,C.Belagal,9,57167,29342,27825
28,552,05257,SUB-DISTRICT,Gudur,11,46266,23494,22772
28,552,05258,SUB-DISTRICT,Kallur,18,51470,25993,25477
28,552,05259,SUB-DISTRICT,Kurnool,18,67268,34162,33106
28,552,05260,SUB-DISTRICT,Nandikotkur,11,83748,41904,41844
28,552,05261,SUB-DISTRICT,Pagidyala,6,35267,17409,17858
28,552,05262,SUB-DISTRICT,Jupadu Bungalow,10,37666,19069,18597
28,552,05263,SUB-DISTRICT,Kothapalle,13,30362,15335,15027
28,552,05264,SUB-DISTRICT,Srisailam,3,10382,5124,5258
28,552,05265,SUB-DISTRICT,Atmakur,12,76028,38670,37358
28,552,05266,SUB-DISTRICT,Pamulapadu,11,40358,20376,19982
28,552,05267,SUB-DISTRICT,Midthur,17,41652,21099,20553
28,552,05268,SUB-DISTRICT,Orvakal,20,58437,29689,28748
28,552,05269,SUB-DISTRICT,Kodumur,10,74594,37891,36703
28,552,05270,SUB-DISTRICT,Gonegandla,16,73873,37236,36637
28,552,05271,SUB-DISTRICT,Adoni,35,84661,42570,42091
28,552,05272,SUB-DISTRICT,Holagunda,20,50592,25533,25059
28,552,05273,SUB-DISTRICT,Halaharvi,24,41123,20910,20213
28,552,05274,SUB-DISTRICT,Alur,18,55834,28568,27266
28,552,05275,SUB-DISTRICT,Aspari,20,65088,33035,32053
28,552,05276,SUB-DISTRICT,Devanakonda,14,71237,36374,34863
28,552,05277,SUB-DISTRICT,Krishnagiri,15,47103,23733,23370
28,552,05278,SUB-DISTRICT,Veldurthi,16,63120,31929,31191
28,552,05279,SUB-DISTRICT,Bethamcherla,10,49732,25002,24730
28,552,05280,SUB-DISTRICT,Panyam,18,51426,25619,25807
28,552,05281,SUB-DISTRICT,Gadivemula,14,42810,21667,21143
28,552,05282,SUB-DISTRICT,Velgode,7,47850,24223,23627
28,552,05283,SUB-DISTRICT,Bandi Atmakur,15,48592,24379,24213
28,552,05284,SUB-DISTRICT,Nandyal,17,57944,29441,28503
28,552,05285,SUB-DISTRICT,Mahanandi,9,38487,19431,19056
28,552,05286,SUB-DISTRICT,Sirvel,12,58014,29395,28619
28,552,05287,SUB-DISTRICT,Gospadu,15,41066,20550,20516
28,552,05288,SUB-DISTRICT,Banaganapalle,36,65898,33280,32618
28,552,05289,SUB-DISTRICT,Dhone,16,60960,31088,29872
28,552,05290,SUB-DISTRICT,Pattikonda,11,68962,34579,34383
28,552,05291,SUB-DISTRICT,Chippagiri,14,33400,16875,16525
28,552,05292,SUB-DISTRICT,Maddikera (East),6,36834,18653,18181
28,552,05293,SUB-DISTRICT,Tuggali,12,59462,30466,28996
28,552,05294,SUB-DISTRICT,Peapally,18,73692,37613,36079
28,552,05295,SUB-DISTRICT,Owk,18,43838,21961,21877
28,552,05296,SUB-DISTRICT,Koilkuntla,17,48559,23998,24561
28,552,05297,SUB-DISTRICT,Rudravaram,19,49003,24703,24300
28,552,05298,SUB-DISTRICT,Allagadda,20,79126,39669,39457
28,552,05299,SUB-DISTRICT,Dornipadu,9,26079,13023,13056
28,552,05300,SUB-DISTRICT,Sanjamala,20,37537,18904,18633
28,552,05301,SUB-DISTRICT,Kolimigundla,20,41228,20855,20373
28,552,05302,SUB-DISTRICT,Uyyalawada,19,28156,14012,14144
28,552,05303,SUB-DISTRICT,Chagalamarri,19,51132,25791,25341
28,553,00000,DISTRICT,Anantapur,921,2935437,1489157,1446280
28,553,05304,SUB-DISTRICT,D.Hirehal,17,46613,23598,23015
28,553,05305,SUB-DISTRICT,Rayadurg,14,40942,20976,19966
28,553,05306,SUB-DISTRICT,Kanekal,17,64979,32908,32071
28,553,05307,SUB-DISTRICT,Bommanahal,16,55989,28121,27868
28,553,05308,SUB-DISTRICT,Vidapanakal,14,53476,27308,26168
28,553,05309,SUB-DISTRICT,Guntakal,18,45385,23197,22188
28,553,05310,SUB-DISTRICT,Gooty,22,40229,20419,19810
28,553,05311,SUB-DISTRICT,Peddavadugur,24,45771,23311,22460
28,553,05312,SUB-DISTRICT,Yadiki,14,56122,28411,27711
28,553,05313,SUB-DISTRICT,Tadpatri,27,57701,29182,28519
28,553,05314,SUB-DISTRICT,Peddapappur,17,34629,17600,17029
28,553,05315,SUB-DISTRICT,Pamidi,22,55303,28035,27268
28,553,05316,SUB-DISTRICT,Vajrakarur,16,50007,25314,24693
28,553,05317,SUB-DISTRICT,Uravakonda,21,44636,22447,22189
28,553,05318,SUB-DISTRICT,Beluguppa,14,43735,22159,21576
28,553,05319,SUB-DISTRICT,Gummagatta,11,49207,24958,24249
28,553,05320,SUB-DISTRICT,Brahmasamudram,13,43162,21520,21642
28,553,05321,SUB-DISTRICT,Kalyandurg,15,57551,29271,28280
28,553,05322,SUB-DISTRICT,Atmakur,8,38970,20037,18933
28,553,05323,SUB-DISTRICT,Kudair,13,38312,19470,18842
28,553,05324,SUB-DISTRICT,Garladinne,18,53780,27299,26481
28,553,05325,SUB-DISTRICT,Singanamala,19,43643,22032,21611
28,553,05326,SUB-DISTRICT,Putlur,17,36902,18699,18203
28,553,05327,SUB-DISTRICT,Yellanur,19,35732,18203,17529
28,553,05328,SUB-DISTRICT,Narpala,12,54973,28026,26947
28,553,05329,SUB-DISTRICT,Bukkaraya Samudram,14,67384,34582,32802
28,553,05330,SUB-DISTRICT,Anantapur,16,53567,27219,26348
28,553,05331,SUB-DISTRICT,Raptadu,11,31900,16416,15484
28,553,05332,SUB-DISTRICT,Settur,9,43172,21955,21217
28,553,05333,SUB-DISTRICT,Kundurpi,10,53180,27145,26035
28,553,05334,SUB-DISTRICT,Kambadur,12,50799,25972,24827
28,553,05335,SUB-DISTRICT,Kanaganapalle,10,39673,20529,19144
28,553,05336,SUB-DISTRICT,Dharmavaram,12,50605,25983,24622
28,553,05337,SUB-DISTRICT,Bathalapalle,11,39373,20117,19256
28,553,05338,SUB-DISTRICT,Tadimarri,11,32385,16426,15959
28,553,05339,SUB-DISTRICT,Mudigubba,26,60469,30435,30034
28,553,05340,SUB-DISTRICT,Talupula,11,42392,21291,21101
28,553,05341,SUB-DISTRICT,Nambulipulikunta,12,31404,15750,15654
28,553,05342,SUB-DISTRICT,Gandlapenta,12,26183,13191,12992
28,553,05343,SUB-DISTRICT,Kadiri,16,35944,18073,17871
28,553,05344,SUB-DISTRICT,Nallamada,10,41376,20963,20413
28,553,05345,SUB-DISTRICT,Bukkapatnam,8,40149,20089,20060
28,553,05346,SUB-DISTRICT,Kothacheruvu,21,39046,19626,19420
28,553,05347,SUB-DISTRICT,Chennekothapalle,11,44351,22679,21672
28,553,05348,SUB-DISTRICT,Ramagiri,10,34001,17364,16637
28,553,05349,SUB-DISTRICT,Roddam,20,51168,25889,25279
28,553,05350,SUB-DISTRICT,Madakasira,19,81227,41068,40159
28,553,05351,SUB-DISTRICT,Amarapuram,8,55771,27997,27774
28,553,05352,SUB-DISTRICT,Gudibanda,13,52610,26964,25646
28,553,05353,SUB-DISTRICT,Rolla,7,39964,20350,19614
28,553,05354,SUB-DISTRICT,Agali,8,36253,18511,17742
28,553,05355,SUB-DISTRICT,Parigi,16,58225,30003,28222
28,553,05356,SUB-DISTRICT,Penukonda,16,55383,28280,27103
28,553,05357,SUB-DISTRICT,Puttaparthi,11,48518,24371,24147
28,553,05358,SUB-DISTRICT,Obuladevaracheruvu,14,48308,24588,23720
28,553,05359,SUB-DISTRICT,Nallacheruvu,11,31036,15550,15486
28,553,05360,SUB-DISTRICT,Tanakal,18,47946,23722,24224
28,553,05361,SUB-DISTRICT,Amadagur,13,29520,14704,14816
28,553,05362,SUB-DISTRICT,Gorantla,18,77271,39009,38262
28,553,05363,SUB-DISTRICT,Somandepalle,19,28696,14692,14004
28,553,05364,SUB-DISTRICT,Hindupur,14,51861,26294,25567
28,553,05365,SUB-DISTRICT,Lepakshi,10,45122,23100,22022
28,553,05366,SUB-DISTRICT,Chilamathur,15,51456,25759,25697
28,554,00000,DISTRICT,Chittoor,1455,2942678,1474052,1468626
28,554,05367,SUB-DISTRICT,Mulakalacheruvu,15,45556,22600,22956
28,554,05368,SUB-DISTRICT,Thamballapalle,16,39914,19850,20064
28,554,05369,SUB-DISTRICT,Peddamandyam,9,34502,17278,17224
28,554,05370,SUB-DISTRICT,Gurramkonda,17,42772,21710,21062
28,554,05371,SUB-DISTRICT,Kalakada,16,34326,17182,17144
28,554,05372,SUB-DISTRICT,Kambhamvaripalle,20,42351,21524,20827
28,554,05373,SUB-DISTRICT,Rompicherla,7,26335,13168,13167
28,554,05374,SUB-DISTRICT,Yerravaripalem,10,28011,14123,13888
28,554,05375,SUB-DISTRICT,Tirupati (Rural),25,50471,25031,25440
28,554,05376,SUB-DISTRICT,Renigunta,30,49758,25095,24663
28,554,05377,SUB-DISTRICT,Yerpedu,32,56403,28131,28272
28,554,05378,SUB-DISTRICT,Srikalahasti,61,57581,28822,28759
28,554,05379,SUB-DISTRICT,Thottambedu,40,43044,21398,21646
28,554,05380,SUB-DISTRICT,Buchinaidu Kandriga,24,34261,17097,17164
28,554,05381,SUB-DISTRICT,Varadaiahpalem,29,45068,22628,22440
28,554,05382,SUB-DISTRICT,K.V.B.Puram,38,42111,20965,21146
28,554,05383,SUB-DISTRICT,Tirupati (Urban),2,4565,2367,2198
28,554,05384,SUB-DISTRICT,Chandragiri,23,57286,28334,28952
28,554,05385,SUB-DISTRICT,Chinnagottigallu,10,26150,13021,13129
28,554,05386,SUB-DISTRICT,Pileru,14,31527,15604,15923
28,554,05387,SUB-DISTRICT,Kalikiri,14,48729,24151,24578
28,554,05388,SUB-DISTRICT,Valmikipuram,17,45274,22445,22829
28,554,05389,SUB-DISTRICT,Kurabalakota,7,41235,20668,20567
28,554,05390,SUB-DISTRICT,Pedda Thippasamudram,19,53079,27181,25898
28,554,05391,SUB-DISTRICT,B.Kothakota,9,59465,30299,29166
28,554,05392,SUB-DISTRICT,Madanapalle,13,53002,26620,26382
28,554,05393,SUB-DISTRICT,Nimmanapalle,10,32890,16220,16670
28,554,05394,SUB-DISTRICT,Sodam,13,34394,17598,16796
28,554,05395,SUB-DISTRICT,Pulicherla,15,37108,18742,18366
28,554,05396,SUB-DISTRICT,Pakala,15,56667,28025,28642
28,554,05397,SUB-DISTRICT,Vedurukuppam,30,46853,23699,23154
28,554,05398,SUB-DISTRICT,Ramachandrapuram,17,31373,15669,15704
28,554,05399,SUB-DISTRICT,Vadamalapeta,19,32407,16196,16211
28,554,05400,SUB-DISTRICT,Narayanavanam,15,25788,12997,12791
28,554,05401,SUB-DISTRICT,Pichatur,17,31524,15510,16014
28,554,05402,SUB-DISTRICT,Satyavedu,30,52979,25995,26984
28,554,05403,SUB-DISTRICT,Nagalapuram,12,34026,16759,17267
28,554,05404,SUB-DISTRICT,Nindra,15,28993,14341,14652
28,554,05405,SUB-DISTRICT,Vijayapuram,17,30048,14952,15096
28,554,05406,SUB-DISTRICT,Nagari,19,33899,16695,17204
28,554,05407,SUB-DISTRICT,Puttur,12,25074,12169,12905
28,554,05408,SUB-DISTRICT,Karvetinagar,25,47764,23720,24044
28,554,05409,SUB-DISTRICT,Penumuru,17,41539,20973,20566
28,554,05410,SUB-DISTRICT,Puthalapattu,20,46412,23258,23154
28,554,05411,SUB-DISTRICT,Irala,18,50631,25344,25287
28,554,05412,SUB-DISTRICT,Somala,13,43528,21795,21733
28,554,05413,SUB-DISTRICT,Chowdepalle,15,42103,21136,20967
28,554,05414,SUB-DISTRICT,Ramasamudram,15,49202,24628,24574
28,554,05415,SUB-DISTRICT,Punganur,18,54956,27410,27546
28,554,05416,SUB-DISTRICT,Peddapanjani,22,58423,29137,29286
28,554,05417,SUB-DISTRICT,Gangavaram,16,53598,26853,26745
28,554,05418,SUB-DISTRICT,Thavanampalle,24,53708,26738,26970
28,554,05419,SUB-DISTRICT,Srirangarajapuram,37,38926,19562,19364
28,554,05420,SUB-DISTRICT,Gangadhara Nellore,34,69543,35293,34250
28,554,05421,SUB-DISTRICT,Chittoor,31,37169,18702,18467
28,554,05422,SUB-DISTRICT,Palamaner,14,30020,15082,14938
28,554,05423,SUB-DISTRICT,Baireddipalle,25,56538,28395,28143
28,554,05424,SUB-DISTRICT,Venkatagirikota,32,88321,44296,44025
28,554,05425,SUB-DISTRICT,Santhipuram,60,61789,31431,30358
28,554,05426,SUB-DISTRICT,Gudupalle,47,45004,22687,22317
28,554,05427,SUB-DISTRICT,Kuppam,62,98516,49865,48651
28,554,05428,SUB-DISTRICT,Ramakuppam,37,57851,29650,28201
28,554,05429,SUB-DISTRICT,Bangarupalem,27,73199,36737,36462
28,554,05430,SUB-DISTRICT,Yadamarri,24,50176,25116,25060
28,554,05431,SUB-DISTRICT,Gudipala,30,43306,21532,21774
28,554,05432,SUB-DISTRICT,Palasamudram,19,23657,11853,11804
29,000,00000,STATE,KARNATAKA,27397,37469335,18929354,18539981
29,555,00000,DISTRICT,Belgaum,1263,3568466,1811094,1757372
29,555,05433,SUB-DISTRICT,Chikodi,132,503838,257240,246598
29,555,05434,SUB-DISTRICT,Athni,109,477990,244533,233457
29,555,05435,SUB-DISTRICT,Raybag ,59,363599,185784,177815
29,555,05436,SUB-DISTRICT,Gokak,131,476448,239622,236826
29,555,05437,SUB-DISTRICT,Hukeri,123,341645,171560,170085
29,555,05438,SUB-DISTRICT,Belgaum,120,313511,159294,154217
29,555,05439,SUB-DISTRICT,Khanapur,217,223987,113404,110583
29,555,05440,SUB-DISTRICT,Sampgaon,132,332007,167934,164073
29,555,05441,SUB-DISTRICT,Parasgad,125,311714,158163,153551
29,555,05442,SUB-DISTRICT,Ramdurg,115,223727,113560,110167
29,556,00000,DISTRICT,Bagalkot ,613,1291906,650267,641639
29,556,05443,SUB-DISTRICT,Jamkhandi,71,298146,151059,147087
29,556,05444,SUB-DISTRICT,Bilgi,63,142502,71342,71160
29,556,05445,SUB-DISTRICT,Mudhol,78,233716,116896,116820
29,556,05446,SUB-DISTRICT,Badami,149,246804,124649,122155
29,556,05447,SUB-DISTRICT,Bagalkot,94,173181,86842,86339
29,556,05448,SUB-DISTRICT,Hungund,158,197557,99479,98078
29,557,00000,DISTRICT,Bijapur,679,1675353,857562,817791
29,557,05449,SUB-DISTRICT,Bijapur,130,393648,202002,191646
29,557,05450,SUB-DISTRICT,Indi,129,382952,198132,184820
29,557,05451,SUB-DISTRICT,Sindgi,149,358449,183855,174594
29,557,05452,SUB-DISTRICT,Basavana Bagevadi,123,315523,160242,155281
29,557,05453,SUB-DISTRICT,Muddebihal,148,224781,113331,111450
29,558,00000,DISTRICT,Bidar,595,1277348,651250,626098
29,558,05454,SUB-DISTRICT,Basavakalyan ,112,275530,140107,135423
29,558,05455,SUB-DISTRICT,Bhalki ,130,237017,120862,116155
29,558,05456,SUB-DISTRICT,Aurad ,148,248299,126924,121375
29,558,05457,SUB-DISTRICT,Bidar ,123,253921,129625,124296
29,558,05458,SUB-DISTRICT,Homnabad ,82,262581,133732,128849
29,559,00000,DISTRICT,Raichur,815,1438464,717972,720492
29,559,05459,SUB-DISTRICT,Lingsugur ,185,297743,150029,147714
29,559,05460,SUB-DISTRICT,Devadurga ,173,251677,125539,126138
29,559,05461,SUB-DISTRICT,Raichur ,145,247476,123267,124209
29,559,05462,SUB-DISTRICT,Manvi ,165,324205,160902,163303
29,559,05463,SUB-DISTRICT,Sindhnur ,147,317363,158235,159128
29,560,00000,DISTRICT,Koppal,595,1156216,582958,573258
29,560,05464,SUB-DISTRICT,Yelbarga ,138,252628,127673,124955
29,560,05465,SUB-DISTRICT,Kushtagi ,165,259914,131734,128180
29,560,05466,SUB-DISTRICT,Gangawati ,148,345263,172397,172866
29,560,05467,SUB-DISTRICT,Koppal ,144,298411,151154,147257
29,561,00000,DISTRICT,Gadag,322,685261,347585,337676
29,561,05468,SUB-DISTRICT,Nargund ,32,64332,32923,31409
29,561,05469,SUB-DISTRICT,Ron ,93,191763,96504,95259
29,561,05470,SUB-DISTRICT,Gadag,60,175883,89133,86750
29,561,05471,SUB-DISTRICT,Shirhatti ,83,146305,74682,71623
29,561,05472,SUB-DISTRICT,Mundargi ,54,106978,54343,52635
29,562,00000,DISTRICT,Dharwad,361,797484,409416,388068
29,562,05473,SUB-DISTRICT,Dharwad,110,232765,119544,113221
29,562,05474,SUB-DISTRICT,Navalgund ,57,137328,70304,67024
29,562,05475,SUB-DISTRICT,Hubli,50,142807,72980,69827
29,562,05476,SUB-DISTRICT,Kalghatgi ,87,137742,71205,66537
29,562,05477,SUB-DISTRICT,Kundgol ,57,146842,75383,71459
29,563,00000,DISTRICT,Uttara Kannada,1243,1018188,514910,503278
29,563,05478,SUB-DISTRICT,Karwar ,50,73671,37279,36392
29,563,05479,SUB-DISTRICT,Supa,114,52012,26167,25845
29,563,05480,SUB-DISTRICT,Haliyal ,110,91563,46603,44960
29,563,05481,SUB-DISTRICT,Yellapur ,124,58210,29563,28647
29,563,05482,SUB-DISTRICT,Mundgod ,84,83638,44708,38930
29,563,05483,SUB-DISTRICT,Sirsi ,228,124026,62680,61346
29,563,05484,SUB-DISTRICT,Ankola ,77,75388,38103,37285
29,563,05485,SUB-DISTRICT,Kumta ,110,117561,59383,58178
29,563,05486,SUB-DISTRICT,Siddapur ,195,83118,41169,41949
29,563,05487,SUB-DISTRICT,Honavar ,92,147155,73670,73485
29,563,05488,SUB-DISTRICT,Bhatkal ,59,111846,55585,56261
29,564,00000,DISTRICT,Haveri,696,1242167,638450,603717
29,564,05489,SUB-DISTRICT,Shiggaon ,91,137174,70703,66471
29,564,05490,SUB-DISTRICT,Savanur ,65,120954,62396,58558
29,564,05491,SUB-DISTRICT,Hangal ,154,232296,118863,113433
29,564,05492,SUB-DISTRICT,Haveri ,90,213260,109841,103419
29,564,05493,SUB-DISTRICT,Byadgi ,64,111010,57013,53997
29,564,05494,SUB-DISTRICT,Hirekerur ,126,211924,108551,103373
29,564,05495,SUB-DISTRICT,Ranibennur ,106,215549,111083,104466
29,565,00000,DISTRICT,Bellary,522,1532356,774093,758263
29,565,05496,SUB-DISTRICT,Hadagalli,56,167252,84819,82433
29,565,05497,SUB-DISTRICT,Hagaribommanahalli,53,188238,95337,92901
29,565,05498,SUB-DISTRICT,Hospet ,67,188965,94673,94292
29,565,05499,SUB-DISTRICT,Siruguppa ,84,190388,94949,95439
29,565,05500,SUB-DISTRICT,Bellary ,97,360484,181595,178889
29,565,05501,SUB-DISTRICT,Sandur ,76,181097,91936,89161
29,565,05502,SUB-DISTRICT,Kudligi ,89,255932,130784,125148
29,566,00000,DISTRICT,Chitradurga,948,1329923,675573,654350
29,566,05503,SUB-DISTRICT,Molakalmuru ,78,125487,64095,61392
29,566,05504,SUB-DISTRICT,Challakere ,182,310590,158343,152247
29,566,05505,SUB-DISTRICT,Chitradurga ,173,272142,138532,133610
29,566,05506,SUB-DISTRICT,Holalkere ,163,185241,93964,91277
29,566,05507,SUB-DISTRICT,Hosdurga ,201,206746,104605,102141
29,566,05508,SUB-DISTRICT,Hiriyur ,151,229717,116034,113683
29,567,00000,DISTRICT,Davanagere,800,1316487,668267,648220
29,567,05509,SUB-DISTRICT,Harihar ,76,163668,83306,80362
29,567,05510,SUB-DISTRICT,Harapanahalli ,79,254964,130398,124566
29,567,05511,SUB-DISTRICT,Jagalur ,135,154565,78288,76277
29,567,05512,SUB-DISTRICT,Davanagere ,154,247008,124983,122025
29,567,05513,SUB-DISTRICT,Honnali ,154,215278,109265,106013
29,567,05514,SUB-DISTRICT,Channagiri ,202,281004,142027,138977
29,568,00000,DISTRICT,Shimoga,1444,1129026,565821,563205
29,568,05515,SUB-DISTRICT,Sagar ,230,140922,69798,71124
29,568,05516,SUB-DISTRICT,Sorab ,281,189477,95507,93970
29,568,05517,SUB-DISTRICT,Shikarpur,155,185350,93949,91401
29,568,05518,SUB-DISTRICT,Hosanagara ,202,112381,55670,56711
29,568,05519,SUB-DISTRICT,Tirthahalli,245,127478,62789,64689
29,568,05520,SUB-DISTRICT,Shimoga ,196,184674,93244,91430
29,568,05521,SUB-DISTRICT,Bhadravati ,135,188744,94864,93880
29,569,00000,DISTRICT,Udupi,233,843300,398847,444453
29,569,05522,SUB-DISTRICT,Kundapura ,98,357798,167859,189939
29,569,05523,SUB-DISTRICT,Udupi,86,302092,143307,158785
29,569,05524,SUB-DISTRICT,Karkal ,49,183410,87681,95729
29,570,00000,DISTRICT,Chikmagalur,1022,898453,447545,450908
29,570,05525,SUB-DISTRICT,Sringeri ,48,32617,16044,16573
29,570,05526,SUB-DISTRICT,Koppa ,80,79889,39287,40602
29,570,05527,SUB-DISTRICT,Narasimharajapura ,57,58632,28712,29920
29,570,05528,SUB-DISTRICT,Tarikere ,213,189338,94969,94369
29,570,05529,SUB-DISTRICT,Kadur ,272,234794,118150,116644
29,570,05530,SUB-DISTRICT,Chikmagalur ,213,186967,93219,93748
29,570,05531,SUB-DISTRICT,Mudigere ,139,116216,57164,59052
29,571,00000,DISTRICT,Tumkur,2582,2079902,1048710,1031192
29,571,05532,SUB-DISTRICT,Chiknayakanhalli ,222,174620,87055,87565
29,571,05533,SUB-DISTRICT,Sira ,234,256204,129920,126284
29,571,05534,SUB-DISTRICT,Pavagada ,149,216708,109381,107327
29,571,05535,SUB-DISTRICT,Madhugiri ,302,238707,120086,118621
29,571,05536,SUB-DISTRICT,Koratagere ,235,152326,76749,75577
29,571,05537,SUB-DISTRICT,Tumkur ,357,290254,150272,139982
29,571,05538,SUB-DISTRICT,Gubbi ,331,244072,122876,121196
29,571,05539,SUB-DISTRICT,Tiptur ,225,163206,81333,81873
29,571,05540,SUB-DISTRICT,Turuvekere ,233,152177,75553,76624
29,571,05541,SUB-DISTRICT,Kunigal ,294,191628,95485,96143
29,572,00000,DISTRICT,Bangalore,562,871607,464256,407351
29,572,05542,SUB-DISTRICT,Bangalore North,189,270195,141675,128520
29,572,05543,SUB-DISTRICT,Bangalore South,97,154523,81043,73480
29,572,05544,SUB-DISTRICT,Bangalore East,55,94464,49485,44979
29,572,05545,SUB-DISTRICT,Anekal,221,352425,192053,160372
29,573,00000,DISTRICT,Mandya,1368,1497407,751243,746164
29,573,05546,SUB-DISTRICT,Krishnarajpet ,299,234533,117259,117274
29,573,05547,SUB-DISTRICT,Nagamangala ,345,170121,84798,85323
29,573,05548,SUB-DISTRICT,Pandavapura ,140,162953,81866,81087
29,573,05549,SUB-DISTRICT,Shrirangapattana ,90,146056,73151,72905
29,573,05550,SUB-DISTRICT,Mandya ,175,277795,139945,137850
29,573,05551,SUB-DISTRICT,Maddur ,152,260285,130316,129969
29,573,05552,SUB-DISTRICT,Malavalli ,167,245664,123908,121756
29,574,00000,DISTRICT,Hassan,2418,1399658,695583,704075
29,574,05553,SUB-DISTRICT,Sakleshpur ,221,105281,51568,53713
29,574,05554,SUB-DISTRICT,Belur ,356,161974,80179,81795
29,574,05555,SUB-DISTRICT,Arsikere ,366,262123,130772,131351
29,574,05556,SUB-DISTRICT,Hassan ,359,218682,108733,109949
29,574,05557,SUB-DISTRICT,Alur ,251,78714,38954,39760
29,574,05558,SUB-DISTRICT,Arkalgud ,279,187775,93829,93946
29,574,05559,SUB-DISTRICT,Hole Narsipur ,211,152213,76664,75549
29,574,05560,SUB-DISTRICT,Channarayapatna,375,232896,114884,118012
29,575,00000,DISTRICT,Dakshina Kannada,331,1093563,541484,552079
29,575,05561,SUB-DISTRICT,Mangalore,74,210033,102613,107420
29,575,05562,SUB-DISTRICT,Bantval ,72,279482,138959,140523
29,575,05563,SUB-DISTRICT,Beltangadi ,79,251802,124672,127130
29,575,05564,SUB-DISTRICT,Puttur,66,226977,112812,114165
29,575,05565,SUB-DISTRICT,Sulya ,40,125269,62428,62841
29,576,00000,DISTRICT,Kodagu,291,473531,234161,239370
29,576,05566,SUB-DISTRICT,Madikeri ,67,113202,56543,56659
29,576,05567,SUB-DISTRICT,Somvarpet ,130,184450,90783,93667
29,576,05568,SUB-DISTRICT,Virajpet ,94,175879,86835,89044
29,577,00000,DISTRICT,Mysore,1199,1755714,887500,868214
29,577,05569,SUB-DISTRICT,Piriyapatna ,196,226391,116471,109920
29,577,05570,SUB-DISTRICT,Hunsur ,195,232098,117516,114582
29,577,05571,SUB-DISTRICT,Krishnarajanagara ,154,216852,108639,108213
29,577,05572,SUB-DISTRICT,Mysore ,123,267541,136294,131247
29,577,05573,SUB-DISTRICT,Heggadadevankote ,241,237968,119929,118039
29,577,05574,SUB-DISTRICT,Nanjangud ,170,334324,168030,166294
29,577,05575,SUB-DISTRICT,Tirumakudal - Narsipur ,120,240540,120621,119919
29,578,00000,DISTRICT,Chamarajanagar,428,845817,424884,420933
29,578,05576,SUB-DISTRICT,Gundlupet ,136,194965,97094,97871
29,578,05577,SUB-DISTRICT,Chamarajanagar ,179,287924,143772,144152
29,578,05578,SUB-DISTRICT,Yelandur ,28,73290,36787,36503
29,578,05579,SUB-DISTRICT,Kollegal ,85,289638,147231,142407
29,579,00000,DISTRICT,Gulbarga,871,1730775,877144,853631
29,579,05580,SUB-DISTRICT,Aland ,134,299836,154167,145669
29,579,05581,SUB-DISTRICT,Afzalpur ,91,193251,99165,94086
29,579,05582,SUB-DISTRICT,Gulbarga ,135,286683,146499,140184
29,579,05583,SUB-DISTRICT,Chincholi ,134,233390,116896,116494
29,579,05584,SUB-DISTRICT,Sedam ,109,172759,85578,87181
29,579,05585,SUB-DISTRICT,Chitapur ,122,273639,136920,136719
29,579,05586,SUB-DISTRICT,Jevargi ,146,271217,137919,133298
29,580,00000,DISTRICT,Yadgir,487,953594,479078,474516
29,580,05587,SUB-DISTRICT,Shorapur ,193,360893,182403,178490
29,580,05588,SUB-DISTRICT,Shahpur,142,294682,148245,146437
29,580,05589,SUB-DISTRICT,Yadgir ,152,298019,148430,149589
29,581,00000,DISTRICT,Kolar,1608,1056328,535431,520897
29,581,05590,SUB-DISTRICT,Srinivaspur ,292,175511,88467,87044
29,581,05591,SUB-DISTRICT,Kolar ,331,246948,125219,121729
29,581,05592,SUB-DISTRICT,Malur ,314,196870,100706,96164
29,581,05593,SUB-DISTRICT,Bangarapet ,356,235340,119428,115912
29,581,05594,SUB-DISTRICT,Mulbagal ,315,201659,101611,100048
29,582,00000,DISTRICT,Chikkaballapura,1324,973985,494463,479522
29,582,05595,SUB-DISTRICT,Gauribidanur ,219,243122,123061,120061
29,582,05596,SUB-DISTRICT,Chikkaballapura,222,148884,76725,72159
29,582,05597,SUB-DISTRICT,Gudibanda ,86,46391,23463,22928
29,582,05598,SUB-DISTRICT,Bagepalli ,211,150576,76062,74514
29,582,05599,SUB-DISTRICT,Sidlaghatta ,245,163010,82872,80138
29,582,05600,SUB-DISTRICT,Chintamani ,341,222002,112280,109722
29,583,00000,DISTRICT,Bangalore Rural,957,722179,371369,350810
29,583,05601,SUB-DISTRICT,Nelamangala ,231,163090,83242,79848
29,583,05602,SUB-DISTRICT,Dod Ballapur ,270,198546,101291,97255
29,583,05603,SUB-DISTRICT,Devanahalli ,193,146705,75798,70907
29,583,05604,SUB-DISTRICT,Hosakote ,263,213838,111038,102800
29,584,00000,DISTRICT,Ramanagara,820,814877,412438,402439
29,584,05605,SUB-DISTRICT,Magadi ,272,167122,84216,82906
29,584,05606,SUB-DISTRICT,Ramanagara,132,161530,82852,78678
29,584,05607,SUB-DISTRICT,Channapatna ,134,189362,94310,95052
29,584,05608,SUB-DISTRICT,Kanakapura ,282,296863,151060,145803
30,000,00000,STATE,GOA,320,551731,275436,276295
30,585,00000,DISTRICT,North Goa,188,324927,163908,161019
30,585,05609,SUB-DISTRICT,Pernem,23,45681,23450,22231
30,585,05610,SUB-DISTRICT,Bardez,28,74321,37191,37130
30,585,05611,SUB-DISTRICT,Tiswadi,22,37549,18459,19090
30,585,05612,SUB-DISTRICT,Bicholim,22,55775,28260,27515
30,585,05613,SUB-DISTRICT,Satari,71,49422,25069,24353
30,585,05614,SUB-DISTRICT,Ponda,22,62179,31479,30700
30,586,00000,DISTRICT,South Goa,132,226804,111528,115276
30,586,05615,SUB-DISTRICT,Mormugao,10,22232,11131,11101
30,586,05616,SUB-DISTRICT,Salcete,35,82000,39099,42901
30,586,05617,SUB-DISTRICT,Quepem,35,36234,18151,18083
30,586,05618,SUB-DISTRICT,Sanguem,45,53600,26909,26691
30,586,05619,SUB-DISTRICT,Canacona,7,32738,16238,16500
31,000,00000,STATE,LAKSHADWEEP,6,14141,7243,6898
31,587,00000,DISTRICT,Lakshadweep,6,14141,7243,6898
31,587,05620,SUB-DISTRICT,Amini,0,0,0,0
31,587,05621,SUB-DISTRICT,Bitra,1,271,154,117
31,587,05622,SUB-DISTRICT,Chetlat,1,2347,1172,1175
31,587,05623,SUB-DISTRICT,Kiltan,1,3946,2012,1934
31,587,05624,SUB-DISTRICT,Kadmat,0,0,0,0
31,587,05625,SUB-DISTRICT,Kavaratti,1,11,11,0
31,587,05626,SUB-DISTRICT,Agatti,2,7566,3894,3672
31,587,05627,SUB-DISTRICT,Andrott ,0,0,0,0
31,587,05628,SUB-DISTRICT,Kalpeni,0,0,0,0
31,587,05629,SUB-DISTRICT,Minicoy,0,0,0,0
32,000,00000,STATE,KERALA,1017,17471135,8408054,9063081
32,588,00000,DISTRICT,Kasaragod,93,798328,387716,410612
32,588,05630,SUB-DISTRICT,Kasaragod,64,446843,219035,227808
32,588,05631,SUB-DISTRICT,Hosdurg,29,351485,168681,182804
32,589,00000,DISTRICT,Kannur,56,882017,425682,456335
32,589,05632,SUB-DISTRICT,Taliparamba ,32,487590,236718,250872
32,589,05633,SUB-DISTRICT,Kannur,2,39161,17862,21299
32,589,05634,SUB-DISTRICT,Thalassery,22,355266,171102,184164
32,590,00000,DISTRICT,Wayanad,48,785840,386283,399557
32,590,05635,SUB-DISTRICT,Mananthavady,16,258140,127543,130597
32,590,05636,SUB-DISTRICT,Sulthanbathery,15,297863,146792,151071
32,590,05637,SUB-DISTRICT,Vythiri,17,229837,111948,117889
32,591,00000,DISTRICT,Kozhikode,51,1013721,484784,528937
32,591,05638,SUB-DISTRICT,Vadakara,12,240044,113796,126248
32,591,05639,SUB-DISTRICT,Quilandy,19,338726,160818,177908
32,591,05640,SUB-DISTRICT,Kozhikode,20,434951,210170,224781
32,592,00000,DISTRICT,Malappuram,83,2295709,1095308,1200401
32,592,05641,SUB-DISTRICT,Ernad,22,594599,290062,304537
32,592,05642,SUB-DISTRICT,Nilambur,18,527693,251647,276046
32,592,05643,SUB-DISTRICT,Perinthalmanna,20,474612,225347,249265
32,592,05644,SUB-DISTRICT,Tirur,16,476158,224030,252128
32,592,05645,SUB-DISTRICT,Tirurangadi,2,60691,29054,31637
32,592,05646,SUB-DISTRICT,Ponnani,5,161956,75168,86788
32,593,00000,DISTRICT,Palakkad,131,2133124,1031466,1101658
32,593,05647,SUB-DISTRICT,Ottappalam,30,679867,322652,357215
32,593,05648,SUB-DISTRICT,Mannarkad,24,349554,169671,179883
32,593,05649,SUB-DISTRICT,Palakkad,20,318583,155185,163398
32,593,05650,SUB-DISTRICT,Chittur,28,366845,180518,186327
32,593,05651,SUB-DISTRICT,Alathur,29,418275,203440,214835
32,594,00000,DISTRICT,Thrissur,98,1024794,488303,536491
32,594,05652,SUB-DISTRICT,Talappilly,42,292045,139982,152063
32,594,05653,SUB-DISTRICT,Chavakkad,7,123976,56714,67262
32,594,05654,SUB-DISTRICT,Thrissur,13,113009,54669,58340
32,594,05655,SUB-DISTRICT,Kodungallur,3,44268,20734,23534
32,594,05656,SUB-DISTRICT,Mukundapuram,33,451496,216204,235292
32,595,00000,DISTRICT,Ernakulam,61,1048025,518510,529515
32,595,05657,SUB-DISTRICT,Kunnathunad,15,266100,131914,134186
32,595,05658,SUB-DISTRICT,Aluva,7,144696,71587,73109
32,595,05659,SUB-DISTRICT,Paravur,2,27246,13233,14013
32,595,05660,SUB-DISTRICT,Kochi,5,117021,57368,59653
32,595,05661,SUB-DISTRICT,Kanayannur,5,32974,16143,16831
32,595,05662,SUB-DISTRICT,Muvattupuzha,17,294251,145955,148296
32,595,05663,SUB-DISTRICT,Kothamangalam,10,165737,82310,83427
32,596,00000,DISTRICT,Idukki ,64,1056929,527245,529684
32,596,05664,SUB-DISTRICT,Devikulam,12,177621,89040,88581
32,596,05665,SUB-DISTRICT,Udumbanchola,23,429780,214379,215401
32,596,05666,SUB-DISTRICT,Thodupuzha,19,273906,136435,137471
32,596,05667,SUB-DISTRICT,Peerumade,10,175622,87391,88231
32,597,00000,DISTRICT,Kottayam,80,1409158,692673,716485
32,597,05668,SUB-DISTRICT,Meenachil,25,349601,173420,176181
32,597,05669,SUB-DISTRICT,Vaikom,16,287180,141266,145914
32,597,05670,SUB-DISTRICT,Kottayam,16,274583,134980,139603
32,597,05671,SUB-DISTRICT,Changanassery,11,227749,110626,117123
32,597,05672,SUB-DISTRICT,Kanjirappally,12,270045,132381,137664
32,598,00000,DISTRICT,Alappuzha,51,979643,464713,514930
32,598,05673,SUB-DISTRICT,Cherthala,8,193645,95023,98622
32,598,05674,SUB-DISTRICT,Ambalappuzha,5,107163,51913,55250
32,598,05675,SUB-DISTRICT,Kuttanad,14,193007,93013,99994
32,598,05676,SUB-DISTRICT,Karthikappally,6,119620,55819,63801
32,598,05677,SUB-DISTRICT,Chengannur,9,145037,66987,78050
32,598,05678,SUB-DISTRICT,Mavelikkara,9,221171,101958,119213
32,599,00000,DISTRICT,Pathanamthitta,64,1065799,499820,565979
32,599,05679,SUB-DISTRICT,Thiruvalla,10,170620,79389,91231
32,599,05680,SUB-DISTRICT,Mallappally,9,134219,63748,70471
32,599,05681,SUB-DISTRICT,Ranni,11,198194,94773,103421
32,599,05682,SUB-DISTRICT,Kozhenchery,20,289001,134418,154583
32,599,05683,SUB-DISTRICT,Adoor,14,273765,127492,146273
32,600,00000,DISTRICT,Kollam,69,1448217,680687,767530
32,600,05684,SUB-DISTRICT,Karunagappally ,6,144390,68328,76062
32,600,05685,SUB-DISTRICT,Kunnathur,7,199456,94863,104593
32,600,05686,SUB-DISTRICT,Pathanapuram,22,386202,181656,204546
32,600,05687,SUB-DISTRICT,Kottarakkara,26,556646,260028,296618
32,600,05688,SUB-DISTRICT,Kollam,8,161523,75812,85711
32,601,00000,DISTRICT,Thiruvananthapuram,68,1529831,724864,804967
32,601,05689,SUB-DISTRICT,Chirayinkeezhu,21,436508,199468,237040
32,601,05690,SUB-DISTRICT,Nedumangad,24,528401,250054,278347
32,601,05691,SUB-DISTRICT,Thiruvananthapuram,5,92562,43887,48675
32,601,05692,SUB-DISTRICT,Neyyattinkara,18,472360,231455,240905
33,000,00000,STATE,TAMIL NADU,15049,37229590,18679065,18550525
33,602,00000,DISTRICT,Thiruvallur,582,1299709,650462,649247
33,602,05693,SUB-DISTRICT,Gummidipoondi,76,159356,80046,79310
33,602,05694,SUB-DISTRICT,Ponneri,129,243676,121799,121877
33,602,05695,SUB-DISTRICT,Uthukkottai,91,139891,69215,70676
33,602,05696,SUB-DISTRICT,Tiruttani,65,166510,83215,83295
33,602,05697,SUB-DISTRICT,Pallipattu,38,151910,76251,75659
33,602,05698,SUB-DISTRICT,Thiruvallur,133,289759,144915,144844
33,602,05699,SUB-DISTRICT,Poonamallee,24,65162,32684,32478
33,602,05700,SUB-DISTRICT,Ambattur,12,54085,27585,26500
33,602,05701,SUB-DISTRICT,Mathavaram,14,29360,14752,14608
33,603,00000,DISTRICT,Chennai,0,0,0,0
33,604,00000,DISTRICT,Kancheepuram,962,1459916,734979,724937
33,604,05702,SUB-DISTRICT,Sriperumbudur,132,220796,112103,108693
33,604,05703,SUB-DISTRICT,Tambaram,7,27396,13762,13634
33,604,05704,SUB-DISTRICT,Alandur ,0,0,0,0
33,604,05705,SUB-DISTRICT,Sholinganallur ,6,70441,35719,34722
33,604,05706,SUB-DISTRICT,Chengalpattu,146,264378,133414,130964
33,604,05707,SUB-DISTRICT,Kancheepuram,157,222626,111553,111073
33,604,05708,SUB-DISTRICT,Uthiramerur,114,122939,61635,61304
33,604,05709,SUB-DISTRICT,Tirukalukundram,95,131183,66179,65004
33,604,05710,SUB-DISTRICT,Maduranthakam,188,222310,111401,110909
33,604,05711,SUB-DISTRICT,Cheyyur,117,177847,89213,88634
33,605,00000,DISTRICT,Vellore,763,2234344,1117101,1117243
33,605,05712,SUB-DISTRICT,Gudiyatham,78,235672,117091,118581
33,605,05713,SUB-DISTRICT,Katpadi,88,248137,122543,125594
33,605,05714,SUB-DISTRICT,Wallajah,69,213602,106728,106874
33,605,05715,SUB-DISTRICT,Arakonam,133,349641,174769,174872
33,605,05716,SUB-DISTRICT,Arcot,95,152294,76008,76286
33,605,05717,SUB-DISTRICT,Vellore,93,254484,126298,128186
33,605,05718,SUB-DISTRICT,Vaniyambadi,48,200000,101375,98625
33,605,05719,SUB-DISTRICT,Ambur,73,179202,88599,90603
33,605,05720,SUB-DISTRICT,Tirupathur,86,401312,203690,197622
33,606,00000,DISTRICT,Tiruvannamalai,1039,1969930,989726,980204
33,606,05721,SUB-DISTRICT,Arani,48,185402,92579,92823
33,606,05722,SUB-DISTRICT,Cheyyar,215,288321,144748,143573
33,606,05723,SUB-DISTRICT,Vandavasi,203,294403,147186,147217
33,606,05724,SUB-DISTRICT,Polur,182,387606,194462,193144
33,606,05725,SUB-DISTRICT,Chengam,117,245555,124704,120851
33,606,05726,SUB-DISTRICT,Thandrampet,66,179553,90128,89425
33,606,05727,SUB-DISTRICT,Tiruvannamalai,208,389090,195919,193171
33,607,00000,DISTRICT,Viluppuram,1431,2939785,1481475,1458310
33,607,05728,SUB-DISTRICT,Gingee,236,390005,196346,193659
33,607,05729,SUB-DISTRICT,Tindivanam,218,351852,176189,175663
33,607,05730,SUB-DISTRICT,Vanur,79,164696,83132,81564
33,607,05731,SUB-DISTRICT,Viluppuram,228,551695,276792,274903
33,607,05732,SUB-DISTRICT,Tirukkoyilur,168,392460,199019,193441
33,607,05733,SUB-DISTRICT,Sankarapuram,178,392306,198257,194049
33,607,05734,SUB-DISTRICT,Kallakkurichi,149,346884,175116,171768
33,607,05735,SUB-DISTRICT,Ulundurpettai,175,349887,176624,173263
33,608,00000,DISTRICT,Salem,517,1707934,883274,824660
33,608,05736,SUB-DISTRICT,Mettur,39,237538,125662,111876
33,608,05737,SUB-DISTRICT,Omalur,80,392042,206000,186042
33,608,05738,SUB-DISTRICT,Edappadi,20,150170,79070,71100
33,608,05739,SUB-DISTRICT,Sankari,40,131347,67841,63506
33,608,05740,SUB-DISTRICT,Salem,89,217208,111901,105307
33,608,05741,SUB-DISTRICT,Yercaud,61,30287,15202,15085
33,608,05742,SUB-DISTRICT,Vazhapadi,59,148502,75050,73452
33,608,05743,SUB-DISTRICT,Attur,95,307218,155480,151738
33,608,05744,SUB-DISTRICT,Gangavalli,34,93622,47068,46554
33,609,00000,DISTRICT,Namakkal   ,362,1030476,520684,509792
33,609,05745,SUB-DISTRICT,Tiruchengode,101,305765,152293,153472
33,609,05746,SUB-DISTRICT,Rasipuram,92,204652,106080,98572
33,609,05747,SUB-DISTRICT,Namakkal,108,379010,191638,187372
33,609,05748,SUB-DISTRICT,Paramathi-Velur,61,141049,70673,70376
33,610,00000,DISTRICT,Erode,287,1093768,552393,541375
33,610,05749,SUB-DISTRICT,Sathyamangalam,66,236139,118827,117312
33,610,05750,SUB-DISTRICT,Bhavani,51,314125,160290,153835
33,610,05751,SUB-DISTRICT,Gobichettipalayam,55,216970,108286,108684
33,610,05752,SUB-DISTRICT,Perundurai,61,141367,72507,68860
33,610,05753,SUB-DISTRICT,Erode,54,185167,92483,92684
33,611,00000,DISTRICT,The Nilgiris,40,299739,145909,153830
33,611,05754,SUB-DISTRICT,Panthalur,4,81341,39726,41615
33,611,05755,SUB-DISTRICT,Gudalur,3,8336,4102,4234
33,611,05756,SUB-DISTRICT,Udhagamandalam,10,85280,41582,43698
33,611,05757,SUB-DISTRICT,Kotagiri,14,66094,32157,33937
33,611,05758,SUB-DISTRICT,Coonoor,4,27131,13111,14020
33,611,05759,SUB-DISTRICT,Kundah,5,31557,15231,16326
33,612,00000,DISTRICT,Dindigul,330,1351735,678605,673130
33,612,05760,SUB-DISTRICT,Palani,50,139078,69765,69313
33,612,05761,SUB-DISTRICT,Oddanchatram,56,152536,76170,76366
33,612,05762,SUB-DISTRICT,Vedasandur,57,253469,127126,126343
33,612,05763,SUB-DISTRICT,Natham,32,135027,68264,66763
33,612,05764,SUB-DISTRICT,Dindigul,60,291928,146267,145661
33,612,05765,SUB-DISTRICT,Attur,20,107752,53507,54245
33,612,05766,SUB-DISTRICT,Kodaikanal,15,70018,35341,34677
33,612,05767,SUB-DISTRICT,Nilakkottai,40,201927,102165,99762
33,613,00000,DISTRICT,Karur ,169,629976,312628,317348
33,613,05768,SUB-DISTRICT,Aravakurichi,56,140285,69514,70771
33,613,05769,SUB-DISTRICT,Karur,34,128648,63711,64937
33,613,05770,SUB-DISTRICT,Krishnarayapuram,22,100937,50358,50579
33,613,05771,SUB-DISTRICT,Kulithalai,35,150267,74252,76015
33,613,05772,SUB-DISTRICT,Kadavur,22,109839,54793,55046
33,614,00000,DISTRICT,Tiruchirappalli,431,1384257,688552,695705
33,614,05773,SUB-DISTRICT,Thottiyam,27,109278,54483,54795
33,614,05774,SUB-DISTRICT,Musiri,59,182267,91335,90932
33,614,05775,SUB-DISTRICT,Thuraiyur,55,200548,99301,101247
33,614,05776,SUB-DISTRICT,Manachanallur,39,136608,68395,68213
33,614,05777,SUB-DISTRICT,Lalgudi,86,195635,96031,99604
33,614,05778,SUB-DISTRICT,Srirangam,49,179883,89664,90219
33,614,05779,SUB-DISTRICT,Tiruchirappalli,1,2686,1351,1335
33,614,05780,SUB-DISTRICT,Thiruverumbur,18,54659,27265,27394
33,614,05781,SUB-DISTRICT,Manapparai,97,322693,160727,161966
33,615,00000,DISTRICT,Perambalur  ,147,468060,233926,234134
33,615,05782,SUB-DISTRICT,Veppanthattai,36,125539,62268,63271
33,615,05783,SUB-DISTRICT,Perambalur,25,100288,50783,49505
33,615,05784,SUB-DISTRICT,Kunnam,86,242233,120875,121358
33,616,00000,DISTRICT,Ariyalur  ,189,671100,333253,337847
33,616,05785,SUB-DISTRICT,Sendurai,28,111891,55373,56518
33,616,05786,SUB-DISTRICT,Udayarpalayam,94,332302,165213,167089
33,616,05787,SUB-DISTRICT,Ariyalur,67,226907,112667,114240
33,617,00000,DISTRICT,Cuddalore,799,1720725,868861,851864
33,617,05788,SUB-DISTRICT,Panruti,80,279444,141056,138388
33,617,05789,SUB-DISTRICT,Cuddalore,69,214298,107913,106385
33,617,05790,SUB-DISTRICT,Kurinjipadi ,53,159039,80343,78696
33,617,05791,SUB-DISTRICT,Chidambaram,171,298909,150348,148561
33,617,05792,SUB-DISTRICT,Kattumannarkoil,148,219121,110210,108911
33,617,05793,SUB-DISTRICT,Virudhachalam,155,329696,167856,161840
33,617,05794,SUB-DISTRICT,Tittakudi,123,220218,111135,109083
33,618,00000,DISTRICT,Nagapattinam  ,486,1251826,619369,632457
33,618,05795,SUB-DISTRICT,Sirkali,87,277112,136920,140192
33,618,05796,SUB-DISTRICT,Mayiladuthurai,59,164985,81857,83128
33,618,05797,SUB-DISTRICT,Kuthalam,55,115823,56856,58967
33,618,05798,SUB-DISTRICT,Tharangambadi,66,183868,90422,93446
33,618,05799,SUB-DISTRICT,Nagapattinam,83,161172,79944,81228
33,618,05800,SUB-DISTRICT,Kilvelur,53,119094,58951,60143
33,618,05801,SUB-DISTRICT,Thirukkuvalai,35,60771,30044,30727
33,618,05802,SUB-DISTRICT,Vedaranyam,48,169001,84375,84626
33,619,00000,DISTRICT,Thiruvarur,538,1006482,499954,506528
33,619,05803,SUB-DISTRICT,Valangaiman,68,88891,44394,44497
33,619,05804,SUB-DISTRICT,Kodavasal,100,182068,91067,91001
33,619,05805,SUB-DISTRICT,Nannilam,70,119197,59888,59309
33,619,05806,SUB-DISTRICT,Thiruvarur,46,93395,46408,46987
33,619,05807,SUB-DISTRICT,Needamangalam,62,112681,55965,56716
33,619,05808,SUB-DISTRICT,Mannargudi,118,241381,119469,121912
33,619,05809,SUB-DISTRICT,Thiruthuraipoondi,74,168869,82763,86106
33,620,00000,DISTRICT,Thanjavur,789,1554531,765177,789354
33,620,05810,SUB-DISTRICT,Thiruvidaimarudur,73,170553,85196,85357
33,620,05811,SUB-DISTRICT,Kumbakonam,100,213009,105989,107020
33,620,05812,SUB-DISTRICT,Papanasam,104,210770,103744,107026
33,620,05813,SUB-DISTRICT,Thiruvaiyaru,75,147593,73058,74535
33,620,05814,SUB-DISTRICT,Thanjavur,83,204040,102715,101325
33,620,05815,SUB-DISTRICT,Orathanadu,117,236624,115186,121438
33,620,05816,SUB-DISTRICT,Pattukkottai,165,275769,132371,143398
33,620,05817,SUB-DISTRICT,Peravurani,72,96173,46918,49255
33,621,00000,DISTRICT,Pudukkottai,732,1301991,645505,656486
33,621,05818,SUB-DISTRICT,Iluppur,85,185575,92278,93297
33,621,05819,SUB-DISTRICT,Kulathur,71,150857,75604,75253
33,621,05820,SUB-DISTRICT,Gandarvakkottai,37,89982,45167,44815
33,621,05821,SUB-DISTRICT,Pudukkottai,39,75621,37636,37985
33,621,05822,SUB-DISTRICT,Thirumayam,80,149912,74537,75375
33,621,05823,SUB-DISTRICT,Ponnamaravathi,49,95803,47483,48320
33,621,05824,SUB-DISTRICT,Alangudi,67,142299,70208,72091
33,621,05825,SUB-DISTRICT,Karambakudi,47,95978,47317,48661
33,621,05826,SUB-DISTRICT,Aranthangi,98,154968,75144,79824
33,621,05827,SUB-DISTRICT,Manamelkudi,68,73746,36372,37374
33,621,05828,SUB-DISTRICT,Avudayarkoil,91,87250,43759,43491
33,622,00000,DISTRICT,Sivaganga,508,926256,462210,464046
33,622,05829,SUB-DISTRICT,Tirupathur,98,224491,112784,111707
33,622,05830,SUB-DISTRICT,Karaikkudi,61,118676,58644,60032
33,622,05831,SUB-DISTRICT,Devakottai,90,105766,53435,52331
33,622,05832,SUB-DISTRICT,Sivaganga,127,242411,119850,122561
33,622,05833,SUB-DISTRICT,Manamadurai,81,150412,75957,74455
33,622,05834,SUB-DISTRICT,Ilayangudi,51,84500,41540,42960
33,623,00000,DISTRICT,Madurai,526,1191451,601247,590204
33,623,05835,SUB-DISTRICT,Melur,79,243056,122129,120927
33,623,05836,SUB-DISTRICT,Madurai North,121,186108,94032,92076
33,623,05837,SUB-DISTRICT,Vadipatti,63,162301,81636,80665
33,623,05838,SUB-DISTRICT,Usilampatti,54,160537,82298,78239
33,623,05839,SUB-DISTRICT,Peraiyur,70,163608,81863,81745
33,623,05840,SUB-DISTRICT,Thirumangalam,93,178451,89933,88518
33,623,05841,SUB-DISTRICT,Madurai South,46,97390,49356,48034
33,624,00000,DISTRICT,Theni  ,80,575418,290880,284538
33,624,05842,SUB-DISTRICT,Bodinayakanur,12,70621,35491,35130
33,624,05843,SUB-DISTRICT,Periyakulam,13,102741,52232,50509
33,624,05844,SUB-DISTRICT,Theni ,10,74493,37343,37150
33,624,05845,SUB-DISTRICT,Uthamapalayam,23,142150,71582,70568
33,624,05846,SUB-DISTRICT,Andipatti,22,185413,94232,91181
33,625,00000,DISTRICT,Virudhunagar,475,962062,480360,481702
33,625,05847,SUB-DISTRICT,Rajapalayam,33,154898,77601,77297
33,625,05848,SUB-DISTRICT,Srivilliputhur,47,143314,71703,71611
33,625,05849,SUB-DISTRICT,Sivakasi,41,161643,80012,81631
33,625,05850,SUB-DISTRICT,Virudhunagar,45,101182,50692,50490
33,625,05851,SUB-DISTRICT,Kariapatti,74,74251,37337,36914
33,625,05852,SUB-DISTRICT,Tiruchuli,109,103290,52072,51218
33,625,05853,SUB-DISTRICT,Aruppukkottai,68,121181,60338,60843
33,625,05854,SUB-DISTRICT,Sattur,58,102303,50605,51698
33,626,00000,DISTRICT,Ramanathapuram,383,942746,474508,468238
33,626,05855,SUB-DISTRICT,Tiruvadanai,92,174992,87479,87513
33,626,05856,SUB-DISTRICT,Paramakudi,93,161331,81382,79949
33,626,05857,SUB-DISTRICT,Mudukulathur,42,98643,49067,49576
33,626,05858,SUB-DISTRICT,Kamuthi,49,112760,57031,55729
33,626,05859,SUB-DISTRICT,Kadaladi,40,130476,65839,64637
33,626,05860,SUB-DISTRICT,Ramanathapuram,66,226725,114547,112178
33,626,05861,SUB-DISTRICT,Rameswaram,1,37819,19163,18656
33,627,00000,DISTRICT,Thoothukkudi,432,873374,430361,443013
33,627,05862,SUB-DISTRICT,Kovilpatti,72,130471,64448,66023
33,627,05863,SUB-DISTRICT,Ettayapuram,55,62219,30187,32032
33,627,05864,SUB-DISTRICT,Vilathikulam,83,115413,57493,57920
33,627,05865,SUB-DISTRICT,Ottapidaram,63,115344,57592,57752
33,627,05866,SUB-DISTRICT,Thoothukkudi,24,66700,33384,33316
33,627,05867,SUB-DISTRICT,Srivaikuntam,65,157642,78006,79636
33,627,05868,SUB-DISTRICT,Tiruchendur,46,141088,68596,72492
33,627,05869,SUB-DISTRICT,Sathankulam,24,84497,40655,43842
33,628,00000,DISTRICT,Tirunelveli ,430,1557004,768728,788276
33,628,05870,SUB-DISTRICT,Sivagiri,19,72498,35269,37229
33,628,05871,SUB-DISTRICT,Sankarankoil,83,284530,140351,144179
33,628,05872,SUB-DISTRICT,Veerakeralamputhur,20,87865,43227,44638
33,628,05873,SUB-DISTRICT,Tenkasi,26,171306,85232,86074
33,628,05874,SUB-DISTRICT,Shenkottai,9,51557,25878,25679
33,628,05875,SUB-DISTRICT,Alangulam,27,125131,61753,63378
33,628,05876,SUB-DISTRICT,Tirunelveli,58,145009,71657,73352
33,628,05877,SUB-DISTRICT,Palayamkottai,40,91176,45240,45936
33,628,05878,SUB-DISTRICT,Ambasamudram,56,182786,90253,92533
33,628,05879,SUB-DISTRICT,Nanguneri,57,149520,73486,76034
33,628,05880,SUB-DISTRICT,Radhapuram,35,195626,96382,99244
33,629,00000,DISTRICT,Kanniyakumari,56,330572,164938,165634
33,629,05881,SUB-DISTRICT,Vilavancode,8,60983,30509,30474
33,629,05882,SUB-DISTRICT,Kalkulam,17,113334,56825,56509
33,629,05883,SUB-DISTRICT,Thovala,12,50496,25099,25397
33,629,05884,SUB-DISTRICT,Agastheeswaram,19,105759,52505,53254
33,630,00000,DISTRICT,Dharmapuri,448,1245931,643215,602716
33,630,05885,SUB-DISTRICT,Palakkodu,94,299568,155018,144550
33,630,05886,SUB-DISTRICT,Harur,166,203245,103774,99471
33,630,05887,SUB-DISTRICT,Pappireddipatti,91,209989,106867,103122
33,630,05888,SUB-DISTRICT,Dharmapuri,59,327930,169450,158480
33,630,05889,SUB-DISTRICT,Pennagaram,38,205199,108106,97093
33,631,00000,DISTRICT,Krishnagiri,602,1451446,742444,709002
33,631,05890,SUB-DISTRICT,Hosur,154,310135,159142,150993
33,631,05891,SUB-DISTRICT,Krishnagiri,138,464232,234646,229586
33,631,05892,SUB-DISTRICT,Denkanikottai,89,309901,159980,149921
33,631,05893,SUB-DISTRICT,Pochampalli,39,172357,88413,83944
33,631,05894,SUB-DISTRICT,Uthangarai,182,194821,100263,94558
33,632,00000,DISTRICT,Coimbatore,219,839105,419032,420073
33,632,05895,SUB-DISTRICT,Mettupalayam,22,137570,68643,68927
33,632,05896,SUB-DISTRICT,Sulur,30,128472,64503,63969
33,632,05897,SUB-DISTRICT,Coimbatore North,32,169265,84785,84480
33,632,05898,SUB-DISTRICT,Coimbatore South,20,82321,41133,41188
33,632,05899,SUB-DISTRICT,Pollachi,115,321477,159968,161509
33,632,05900,SUB-DISTRICT,Valparai,0,0,0,0
33,633,00000,DISTRICT,Tiruppur,297,957941,479309,478632
33,633,05901,SUB-DISTRICT,Kangeyam,39,123667,61824,61843
33,633,05902,SUB-DISTRICT,Dharapuram,62,170965,85519,85446
33,633,05903,SUB-DISTRICT,Avanashi,76,196776,98134,98642
33,633,05904,SUB-DISTRICT,Tiruppur,10,64322,32601,31721
33,633,05905,SUB-DISTRICT,Palladam,25,139360,69911,69449
33,633,05906,SUB-DISTRICT,Udumalaipettai,50,132190,66124,66066
33,633,05907,SUB-DISTRICT,Madathukulam,35,130661,65196,65465
34,000,00000,STATE,PUDUCHERRY,90,395200,194907,200293
34,634,00000,DISTRICT,Yanam,0,0,0,0
34,634,05908,SUB-DISTRICT,Yanam Taluk,0,0,0,0
34,635,00000,DISTRICT,Puducherry,62,293080,144769,148311
34,635,05909,SUB-DISTRICT,Puducherry Taluk,4,26581,13011,13570
34,635,05910,SUB-DISTRICT,Ozhukarai Taluk,0,0,0,0
34,635,05911,SUB-DISTRICT,Villianur Taluk,36,146024,72421,73603
34,635,05912,SUB-DISTRICT,Bahour Taluk,22,120475,59337,61138
34,636,00000,DISTRICT,Mahe,0,0,0,0
34,636,05913,SUB-DISTRICT,Mahe Taluk,0,0,0,0
34,637,00000,DISTRICT,Karaikal,28,102120,50138,51982
34,637,05914,SUB-DISTRICT,Karaikal Taluk,12,46098,22657,23441
34,637,05915,SUB-DISTRICT,Thirunallar Taluk,16,56022,27481,28541
35,000,00000,STATE,ANDAMAN & NICOBAR ISLANDS,396,237093,126287,110806
35,638,00000,DISTRICT,Nicobars,90,36842,20727,16115
35,638,05916,SUB-DISTRICT,Car Nicobar,16,17841,9735,8106
35,638,05917,SUB-DISTRICT,Nancowry,44,10634,5967,4667
35,638,05918,SUB-DISTRICT,Great Nicobar,30,8367,5025,3342
35,639,00000,DISTRICT,North  & Middle Andaman,198,102856,53457,49399
35,639,05919,SUB-DISTRICT,Diglipur,72,43183,22599,20584
35,639,05920,SUB-DISTRICT,Mayabunder,47,25788,13329,12459
35,639,05921,SUB-DISTRICT,Rangat,79,33885,17529,16356
35,640,00000,DISTRICT,South Andaman,108,97395,52103,45292
35,640,05922,SUB-DISTRICT,Ferrargunj,62,45603,23817,21786
35,640,05923,SUB-DISTRICT,Port Blair,30,32969,18322,14647
35,640,05924,SUB-DISTRICT,Little Andaman,16,18823,9964,8859
